AAAACTCCTATTGCCACAG -> AAACTCCTATTGCCACAGC
AAAAGAACCGTACCGGTAG -> AAAGAACCGTACCGGTAGA
AAAAGAGAAGTAAGTAAGT -> AAAGAGAAGTAAGTAAGTC
AAAAGAGATCGGGGATTAT -> AAAGAGATCGGGGATTATG
AAAAGGACTTTCAGATTAA -> AAAGGACTTTCAGATTAAG
AAAAGGTGGGCGTGTCTTC -> AAAGGTGGGCGTGTCTTCG
AAAATATTGTCGGTGGGCG -> AAATATTGTCGGTGGGCGT
AAACACGGTGGGCGTTCCG -> AACACGGTGGGCGTTCCGA
AAACCGAGTCAGATTGACC -> AACCGAGTCAGATTGACCC
AAACGTCGGGATTACCTGG -> AACGTCGGGATTACCTGGA
AAACTCCTATTGCCACAGC -> AACTCCTATTGCCACAGCT
AAACTTTGCGCCATGACAA -> AACTTTGCGCCATGACAAC
AAACTTTGGTTTTTGTGCC -> AACTTTGGTTTTTGTGCCG
AAAGAACCGTACCGGTAGA -> AAGAACCGTACCGGTAGAC
AAAGACGCAGTAATCCAGG -> AAGACGCAGTAATCCAGGA
AAAGACTTTAGTGGGTTGC -> AAGACTTTAGTGGGTTGCA
AAAGAGAAGTAAGTAAGTC -> AAGAGAAGTAAGTAAGTCG
AAAGAGATCGGGGATTATG -> AAGAGATCGGGGATTATGT
AAAGAGCGAAGACGTGAAC -> AAGAGCGAAGACGTGAACC
AAAGCGCTAAGCGGCTGAA -> AAGCGCTAAGCGGCTGAAT
AAAGGACTTTCAGATTAAG -> AAGGACTTTCAGATTAAGC
AAAGGCCTAATCTCTACCC -> AAGGCCTAATCTCTACCCA
AAAGGTGGGCGTGTCTTCG -> AAGGTGGGCGTGTCTTCGA
AAAGTAAGTAAGAGACTTA -> AAGTAAGTAAGAGACTTAG
AAAGTGAAGAATCTTTGAA -> AAGTGAAGAATCTTTGAAG
AAAGTGATAGTCACTCGGA -> AAGTGATAGTCACTCGGAC
AAAGTTGAATTCATTGCGG -> AAGTTGAATTCATTGCGGG
AAATAGGTTTGCAATGTTA -> AATAGGTTTGCAATGTTAC
AAATATTGTCGGTGGGCGT -> AATATTGTCGGTGGGCGTT
AAATGCTAATGGTTGATGA -> AATGCTAATGGTTGATGAC
AAATTAGAGCTGGCCCACG -> AATTAGAGCTGGCCCACGA
AAATTGTATCATGCCGGGA -> AATTGTATCATGCCGGGAG
AACAAAAGAGATCGGGGAT -> ACAAAAGAGATCGGGGATT
AACAAAGACGCAGTAATCC -> ACAAAGACGCAGTAATCCA
AACAAGTGTCCGCGAGTTG -> ACAAGTGTCCGCGAGTTGG
AACAATGCCTGTCCGTTCA -> ACAATGCCTGTCCGTTCAA
AACACGGTGGGCGTTCCGA -> ACACGGTGGGCGTTCCGAA
AACAGGTGAATACGTCACA -> ACAGGTGAATACGTCACAC
AACAGTACTCTTGCCATTA -> ACAGTACTCTTGCCATTAC
AACATACCGGGAACCCTAG -> ACATACCGGGAACCCTAGG
AACCACCGTATAAAGTAAG -> ACCACCGTATAAAGTAAGT
AACCCTAGGGAGTGATATC -> ACCCTAGGGAGTGATATCT
AACCGAGTCAGATTGACCC -> ACCGAGTCAGATTGACCCG
AACCGCCGCCGTGATCGAC -> ACCGCCGCCGTGATCGACT
AACCGTACCGGTAGACCTC -> ACCGTACCGGTAGACCTCT
AACCGTACTTACACCACAC -> ACCGTACTTACACCACACT
AACCGTTTAATCTGGATCT -> ACCGTTTAATCTGGATCTA
AACCTAATATTTCGAGAGA -> ACCTAATATTTCGAGAGAT
AACGACCATTTCGCTCGTG -> ACGACCATTTCGCTCGTGC
AACGCGGGAAACGTCGGGA -> ACGCGGGAAACGTCGGGAT
AACGCTCAGAGCGCAAAGC -> ACGCTCAGAGCGCAAAGCG
AACGGAAACCGAGTCAGAT -> ACGGAAACCGAGTCAGATT
AACGTCGGGATTACCTGGA -> ACGTCGGGATTACCTGGAG
AACGTGCAAAATATTGTCG -> ACGTGCAAAATATTGTCGG
AACTACGGCCTCATTGTTG -> ACTACGGCCTCATTGTTGA
AACTCATGAGGACTCCGTG -> ACTCATGAGGACTCCGTGG
AACTCCTATTGCCACAGCT -> ACTCCTATTGCCACAGCTC
AACTCCTCACGCACCTCCC -> ACTCCTCACGCACCTCCCG
AACTCCTTGTACTAATATT -> ACTCCTTGTACTAATATTC
AACTGATGGTGATTTTGTA -> ACTGATGGTGATTTTGTAC
AACTGCTGCAAAGTGAAGA -> ACTGCTGCAAAGTGAAGAA
AACTTAACAGGTGAATACG -> ACTTAACAGGTGAATACGT
AACTTTAGGCAATGCTAAG -> ACTTTAGGCAATGCTAAGC
AACTTTGCGCCATGACAAC -> ACTTTGCGCCATGACAACA
AACTTTGGTTTTTGTGCCG -> ACTTTGGTTTTTGTGCCGT
AAGAAATAGGTTTGCAATG -> AGAAATAGGTTTGCAATGT
AAGAACAAAAGAGATCGGG -> AGAACAAAAGAGATCGGGG
AAGAACCGTACCGGTAGAC -> AGAACCGTACCGGTAGACC
AAGAATCTTTGAAGGGCGG -> AGAATCTTTGAAGGGCGGT
AAGAATGATTTCGCATTCG -> AGAATGATTTCGCATTCGA
AAGACACGTGCTTAGACAC -> AGACACGTGCTTAGACACC
AAGACGCAGTAATCCAGGA -> AGACGCAGTAATCCAGGAA
AAGACGTGAACCGTACTTA -> AGACGTGAACCGTACTTAC
AAGACTTGTATGATCTCGC -> AGACTTGTATGATCTCGCC
AAGACTTTAGTGGGTTGCA -> AGACTTTAGTGGGTTGCAG
AAGAGAAGTAAGTAAGTCG -> AGAGAAGTAAGTAAGTCGC
AAGAGACTTAGCGCCACCG -> AGAGACTTAGCGCCACCGC
AAGAGATCGGGGATTATGT -> AGAGATCGGGGATTATGTG
AAGAGCGAAGACGTGAACC -> AGAGCGAAGACGTGAACCG
AAGAGGTAGTCCTCAGAGG -> AGAGGTAGTCCTCAGAGGG
AAGCACGTTAGGCCAACCG -> AGCACGTTAGGCCAACCGT
AAGCGAACTCCTCACGCAC -> AGCGAACTCCTCACGCACC
AAGCGCTAAGCGGCTGAAT -> AGCGCTAAGCGGCTGAATC
AAGCGGCTGAATCGCAAAG -> AGCGGCTGAATCGCAAAGA
AAGCGGGTAGGTGATCCTG -> AGCGGGTAGGTGATCCTGT
AAGGACTTTCAGATTAAGC -> AGGACTTTCAGATTAAGCG
AAGGATGCTATCGCTAGGC -> AGGATGCTATCGCTAGGCG
AAGGCCCGAGGTAACCTAA -> AGGCCCGAGGTAACCTAAT
AAGGCCTAATCTCTACCCA -> AGGCCTAATCTCTACCCAC
AAGGGCGGTCCGGTGTCCA -> AGGGCGGTCCGGTGTCCAC
AAGGTCCGGAGGTTTAAAA -> AGGTCCGGAGGTTTAAAAG
AAGGTGGGCGTGTCTTCGA -> AGGTGGGCGTGTCTTCGAT
AAGTAAGAGACTTAGCGCC -> AGTAAGAGACTTAGCGCCA
AAGTAAGTAAGAGACTTAG -> AGTAAGTAAGAGACTTAGC
AAGTAAGTAAGTCGCCAAT -> AGTAAGTAAGTCGCCAATG
AAGTAAGTCGCCAATGCCT -> AGTAAGTCGCCAATGCCTA
AAGTCAGAGTTCACTTGAA -> AGTCAGAGTTCACTTGAAG
AAGTCGCCAATGCCTACGG -> AGTCGCCAATGCCTACGGA
AAGTGAAGAATCTTTGAAG -> AGTGAAGAATCTTTGAAGG
AAGTGATAGTCACTCGGAC -> AGTGATAGTCACTCGGACT
AAGTGGAGAGCTAGGCTTC -> AGTGGAGAGCTAGGCTTCG
AAGTGTCCGATTGTTATAC -> AGTGTCCGATTGTTATACG
AAGTGTCCGCGAGTTGGCG -> AGTGTCCGCGAGTTGGCGC
AAGTTCAAATTGTATCATG -> AGTTCAAATTGTATCATGC
AAGTTGAATTCATTGCGGG -> AGTTGAATTCATTGCGGGA
AATAAACACGGTGGGCGTT -> ATAAACACGGTGGGCGTTC
AATAACGTGCAAAATATTG -> ATAACGTGCAAAATATTGT
AATACATTCCGTAGGTCAA -> ATACATTCCGTAGGTCAAT
AATACGTCACACCTCGGTT -> ATACGTCACACCTCGGTTT
AATACTAGCCTGGGTAAAA -> ATACTAGCCTGGGTAAAAG
AATACTTTTACTCAGATTG -> ATACTTTTACTCAGATTGC
AATAGGAAAACTCCTATTG -> ATAGGAAAACTCCTATTGC
AATAGGTAGTTCTGCGTAA -> ATAGGTAGTTCTGCGTAAG
AATAGGTTTGCAATGTTAC -> ATAGGTTTGCAATGTTACG
AATAGTGACCGGGATGGTC -> ATAGTGACCGGGATGGTCT
AATATATCCTTCAGACAAT -> ATATATCCTTCAGACAATA
AATATCATCCATATAATTG -> ATATCATCCATATAATTGC
AATATTCAAGAAATAGGTT -> ATATTCAAGAAATAGGTTT
AATATTGTCGGTGGGCGTT -> ATATTGTCGGTGGGCGTTC
AATATTTCGAGAGATCGCG -> ATATTTCGAGAGATCGCGC
AATCAAGCGAACTCCTCAC -> ATCAAGCGAACTCCTCACG
AATCAATTGAAATTAGAGC -> ATCAATTGAAATTAGAGCT
AATCCAGGAAGAACAAAAG -> ATCCAGGAAGAACAAAAGA
AATCGCAAAGAGCGAAGAC -> ATCGCAAAGAGCGAAGACG
AATCTCGGTCCCTGGAAAC -> ATCTCGGTCCCTGGAAACT
AATCTCTACCCACTTTCAG -> ATCTCTACCCACTTTCAGG
AATCTGGATCTACTCCCCA -> ATCTGGATCTACTCCCCAA
AATCTTTGAAGGGCGGTCC -> ATCTTTGAAGGGCGGTCCG
AATCTTTTCCTAACTCCTT -> ATCTTTTCCTAACTCCTTG
AATGATTTCGCATTCGAAT -> ATGATTTCGCATTCGAATG
AATGCAAAAGAGAAGTAAG -> ATGCAAAAGAGAAGTAAGT
AATGCCTACGGACTGTTAC -> ATGCCTACGGACTGTTACA
AATGCCTGTCCGTTCAAAG -> ATGCCTGTCCGTTCAAAGT
AATGCTAAGCACGTTAGGC -> ATGCTAAGCACGTTAGGCC
AATGCTAATGGTTGATGAC -> ATGCTAATGGTTGATGACC
AATGGCCAACGGAAACCGA -> ATGGCCAACGGAAACCGAG
AATGGTTGATGACCGTACA -> ATGGTTGATGACCGTACAG
AATGTTACGGGTACAGAAG -> ATGTTACGGGTACAGAAGG
AATTAGAGCTGGCCCACGA -> ATTAGAGCTGGCCCACGAG
AATTATCTTGAAGAGGTAG -> ATTATCTTGAAGAGGTAGT
AATTATTGATGACGACAAC -> ATTATTGATGACGACAACA
AATTCATTGCGGGACCTTC -> ATTCATTGCGGGACCTTCG
AATTGAAATTAGAGCTGGC -> ATTGAAATTAGAGCTGGCC
AATTGCCACAGCTCTTACA -> ATTGCCACAGCTCTTACAC
AATTGTATCATGCCGGGAG -> ATTGTATCATGCCGGGAGT
AATTTATACTCACCGGGTG -> ATTTATACTCACCGGGTGA
AATTTCATCATCGTGGCGT -> ATTTCATCATCGTGGCGTA
ACAAAAGAGATCGGGGATT -> CAAAAGAGATCGGGGATTA
ACAAAGACGCAGTAATCCA -> CAAAGACGCAGTAATCCAG
ACAAAGACTTTAGTGGGTT -> CAAAGACTTTAGTGGGTTG
ACAACAGTACTCTTGCCAT -> CAACAGTACTCTTGCCATT
ACAACATACCGGGAACCCT -> CAACATACCGGGAACCCTA
ACAAGTGTCCGCGAGTTGG -> CAAGTGTCCGCGAGTTGGC
ACAATAAACACGGTGGGCG -> CAATAAACACGGTGGGCGT
ACAATCAATTGAAATTAGA -> CAATCAATTGAAATTAGAG
ACAATGCCTGTCCGTTCAA -> CAATGCCTGTCCGTTCAAA
ACAATTTCATCATCGTGGC -> CAATTTCATCATCGTGGCG
ACACAGATGGTGTGACGGA -> CACAGATGGTGTGACGGAT
ACACCACACTGGACTACAA -> CACCACACTGGACTACAAA
ACACCAGATCCCTTTACCG -> CACCAGATCCCTTTACCGC
ACACCATCGACCCAACCGC -> CACCATCGACCCAACCGCC
ACACCATGTCGCAACGCTC -> CACCATGTCGCAACGCTCA
ACACCCACAGCTCTTACAC -> CACCCACAGCTCTTACACA
ACACCTCGGTTTAGTTAAT -> CACCTCGGTTTAGTTAATA
ACACGACTGGAGTAGGGTA -> CACGACTGGAGTAGGGTAC
ACACGCCACAGCTCTTACA -> CACGCCACAGCTCTTACAC
ACACGGTGGGCGTTCCGAA -> CACGGTGGGCGTTCCGAAT
ACACGTGCTTAGACACCAG -> CACGTGCTTAGACACCAGA
ACACTGGACTACAAAGACT -> CACTGGACTACAAAGACTT
ACACTTCGGGGAAGTTCAA -> CACTTCGGGGAAGTTCAAA
ACAGAAGGATGCTATCGCT -> CAGAAGGATGCTATCGCTA
ACAGATCCCCGATTCAATC -> CAGATCCCCGATTCAATCT
ACAGATGGTGTGACGGATA -> CAGATGGTGTGACGGATAG
ACAGATGTAGTCGCCAAGA -> CAGATGTAGTCGCCAAGAC
ACAGCTCTTACACAGATGG -> CAGCTCTTACACAGATGGT
ACAGCTCTTACACCCACAG -> CAGCTCTTACACCCACAGC
ACAGCTCTTACACGCCACA -> CAGCTCTTACACGCCACAG
ACAGCTCTTACACTTCGGG -> CAGCTCTTACACTTCGGGG
ACAGGCAAAGTTGAATTCA -> CAGGCAAAGTTGAATTCAT
ACAGGTGAATACGTCACAC -> CAGGTGAATACGTCACACC
ACAGTACTCTTGCCATTAC -> CAGTACTCTTGCCATTACC
ACATACCGGGAACCCTAGG -> CATACCGGGAACCCTAGGG
ACATGATTCTTCATCACAC -> CATGATTCTTCATCACACG
ACATGCGGTTTGGGGTAGG -> CATGCGGTTTGGGGTAGGC
ACATGTTGCCAGCAACTAC -> CATGTTGCCAGCAACTACG
ACATTCCGTAGGTCAATTA -> CATTCCGTAGGTCAATTAT
ACATTGATTTTCGTTGCCC -> CATTGATTTTCGTTGCCCA
ACCACACTGGACTACAAAG -> CCACACTGGACTACAAAGA
ACCACCGTATAAAGTAAGT -> CCACCGTATAAAGTAAGTA
ACCAGATCCCTTTACCGCG -> CCAGATCCCTTTACCGCGG
ACCATCGACCCAACCGCCG -> CCATCGACCCAACCGCCGC
ACCATGTCGCAACGCTCAG -> CCATGTCGCAACGCTCAGA
ACCATTTCGCTCGTGCCTG -> CCATTTCGCTCGTGCCTGG
ACCCAACCGCCGCCGTGAT -> CCCAACCGCCGCCGTGATC
ACCCACAGCTCTTACACAG -> CCCACAGCTCTTACACAGA
ACCCACTTTCAGGGAGTAC -> CCCACTTTCAGGGAGTACT
ACCCGCCCTATAACTGATG -> CCCGCCCTATAACTGATGG
ACCCTAGGGAGTGATATCT -> CCCTAGGGAGTGATATCTG
ACCGAGTCAGATTGACCCG -> CCGAGTCAGATTGACCCGC
ACCGCCCTGCGTCCAAAAG -> CCGCCCTGCGTCCAAAAGA
ACCGCCGCCGTGATCGACT -> CCGCCGCCGTGATCGACTA
ACCGCGGGAGAATTATCTT -> CCGCGGGAGAATTATCTTG
ACCGGGAACCCTAGGGAGT -> CCGGGAACCCTAGGGAGTG
ACCGGGATGGTCTGAGTCG -> CCGGGATGGTCTGAGTCGG
ACCGGGTGACTATTGGATG -> CCGGGTGACTATTGGATGC
ACCGGTAGACCTCTTTATT -> CCGGTAGACCTCTTTATTC
ACCGTACAGGCAAAGTTGA -> CCGTACAGGCAAAGTTGAA
ACCGTACCGGTAGACCTCT -> CCGTACCGGTAGACCTCTT
ACCGTACTTACACCACACT -> CCGTACTTACACCACACTG
ACCGTATAAAGTAAGTAAG -> CCGTATAAAGTAAGTAAGA
ACCGTTTAATCTGGATCTA -> CCGTTTAATCTGGATCTAC
ACCTAATATTTCGAGAGAT -> CCTAATATTTCGAGAGATC
ACCTCCCGGTAATCTTTTC -> CCTCCCGGTAATCTTTTCC
ACCTCGGTTTAGTTAATAC -> CCTCGGTTTAGTTAATACT
ACCTCTTTATTCGGGGAAT -> CCTCTTTATTCGGGGAATA
ACCTGGAGATCTTCTGTAT -> CCTGGAGATCTTCTGTATC
ACCTGTCTCTCCGAGATGA -> CCTGTCTCTCCGAGATGAG
ACCTTCAACTTAACAGGTG -> CCTTCAACTTAACAGGTGA
ACCTTCGGTGTGTCCGGGT -> CCTTCGGTGTGTCCGGGTG
ACGACAACATACCGGGAAC -> CGACAACATACCGGGAACC
ACGACCATTTCGCTCGTGC -> CGACCATTTCGCTCGTGCC
ACGACTGGAGTAGGGTACC -> CGACTGGAGTAGGGTACCT
ACGAGCCTCGTGTCGAACA -> CGAGCCTCGTGTCGAACAA
ACGAGTGACGTCCAGTCGA -> CGAGTGACGTCCAGTCGAT
ACGAGTTCGTTGCGGTTCA -> CGAGTTCGTTGCGGTTCAT
ACGCACCTCCCGGTAATCT -> CGCACCTCCCGGTAATCTT
ACGCAGTAATCCAGGAAGA -> CGCAGTAATCCAGGAAGAA
ACGCCACAGCTCTTACACT -> CGCCACAGCTCTTACACTT
ACGCGGGAAACGTCGGGAT -> CGCGGGAAACGTCGGGATT
ACGCTCAGAGCGCAAAGCG -> CGCTCAGAGCGCAAAGCGC
ACGGAAACCGAGTCAGATT -> CGGAAACCGAGTCAGATTG
ACGGACTGTTACACCATCG -> CGGACTGTTACACCATCGA
ACGGATAGCAGTATAGCGT -> CGGATAGCAGTATAGCGTT
ACGGCCTCATTGTTGACAA -> CGGCCTCATTGTTGACAAT
ACGGGTACAGAAGGATGCT -> CGGGTACAGAAGGATGCTA
ACGGTGGGCGTTCCGAATA -> CGGTGGGCGTTCCGAATAA
ACGTAATCAAGCGAACTCC -> CGTAATCAAGCGAACTCCT
ACGTAGAACTGCTGCAAAG -> CGTAGAACTGCTGCAAAGT
ACGTCACACCTCGGTTTAG -> CGTCACACCTCGGTTTAGT
ACGTCCAGTCGATGGCAGA -> CGTCCAGTCGATGGCAGAT
ACGTCGGGATTACCTGGAG -> CGTCGGGATTACCTGGAGA
ACGTCGGTACGTAATCAAG -> CGTCGGTACGTAATCAAGC
ACGTGAACCGTACTTACAC -> CGTGAACCGTACTTACACC
ACGTGCAAAATATTGTCGG -> CGTGCAAAATATTGTCGGT
ACGTGCTTAGACACCAGAT -> CGTGCTTAGACACCAGATC
ACGTGGGTTCATTCCCCAT -> CGTGGGTTCATTCCCCATG
ACGTTAGGCCAACCGTTTA -> CGTTAGGCCAACCGTTTAA
ACTAATATTCAAGAAATAG -> CTAATATTCAAGAAATAGG
ACTACAAAGACTTTAGTGG -> CTACAAAGACTTTAGTGGG
ACTACATTGATTTTCGTTG -> CTACATTGATTTTCGTTGC
ACTACGGCCTCATTGTTGA -> CTACGGCCTCATTGTTGAC
ACTAGCCTGGGTAAAAGGT -> CTAGCCTGGGTAAAAGGTG
ACTATTGGATGCGTTTGTA -> CTATTGGATGCGTTTGTAC
ACTCACATGATTCTTCATC -> CTCACATGATTCTTCATCA
ACTCACCGGGTGACTATTG -> CTCACCGGGTGACTATTGG
ACTCAGATTGCGGTGGGCG -> CTCAGATTGCGGTGGGCGT
ACTCATGAGGACTCCGTGG -> CTCATGAGGACTCCGTGGG
ACTCCCCAAGTGGAGAGCT -> CTCCCCAAGTGGAGAGCTA
ACTCCGTGGGAAACTTTGC -> CTCCGTGGGAAACTTTGCG
ACTCCTATTGCCACAGCTC -> CTCCTATTGCCACAGCTCT
ACTCCTCACGCACCTCCCG -> CTCCTCACGCACCTCCCGG
ACTCCTTGTACTAATATTC -> CTCCTTGTACTAATATTCA
ACTCGGACTGTTCGAGGCT -> CTCGGACTGTTCGAGGCTA
ACTCTTCACATGCGGTTTG -> CTCTTCACATGCGGTTTGG
ACTCTTGCCATTACCTTCA -> CTCTTGCCATTACCTTCAA
ACTGATGGTGATTTTGTAC -> CTGATGGTGATTTTGTACG
ACTGCTGCAAAGTGAAGAA -> CTGCTGCAAAGTGAAGAAT
ACTGGACTACAAAGACTTT -> CTGGACTACAAAGACTTTA
ACTGGAGTAGGGTACCTGT -> CTGGAGTAGGGTACCTGTC
ACTGTTACACCATCGACCC -> CTGTTACACCATCGACCCA
ACTGTTCGAGGCTAACGCG -> CTGTTCGAGGCTAACGCGG
ACTTAACAGGTGAATACGT -> CTTAACAGGTGAATACGTC
ACTTACACCACACTGGACT -> CTTACACCACACTGGACTA
ACTTAGCGCCACCGCCCTG -> CTTAGCGCCACCGCCCTGC
ACTTCGGGGAAGTTCAAAT -> CTTCGGGGAAGTTCAAATT
ACTTGAAGGCCCGAGGTAA -> CTTGAAGGCCCGAGGTAAC
ACTTGTATGATCTCGCCTA -> CTTGTATGATCTCGCCTAT
ACTTTAGGCAATGCTAAGC -> CTTTAGGCAATGCTAAGCA
ACTTTAGTGGGTTGCAGTC -> CTTTAGTGGGTTGCAGTCT
ACTTTCAGATTAAGCGGGT -> CTTTCAGATTAAGCGGGTA
ACTTTCAGGGAGTACTCAC -> CTTTCAGGGAGTACTCACA
ACTTTGCGCCATGACAACA -> CTTTGCGCCATGACAACAG
ACTTTGGTTTTTGTGCCGT -> CTTTGGTTTTTGTGCCGTC
ACTTTTACTCAGATTGCGG -> CTTTTACTCAGATTGCGGT
ACTTTTCTCAACGACCATT -> CTTTTCTCAACGACCATTT
AGAAATAGGTTTGCAATGT -> GAAATAGGTTTGCAATGTT
AGAACAAAAGAGATCGGGG -> GAACAAAAGAGATCGGGGA
AGAACCGTACCGGTAGACC -> GAACCGTACCGGTAGACCT
AGAACTGCTGCAAAGTGAA -> GAACTGCTGCAAAGTGAAG
AGAAGGATGCTATCGCTAG -> GAAGGATGCTATCGCTAGG
AGAAGTAAGTAAGTCGCCA -> GAAGTAAGTAAGTCGCCAA
AGAATAGGTAGTTCTGCGT -> GAATAGGTAGTTCTGCGTA
AGAATCTTTGAAGGGCGGT -> GAATCTTTGAAGGGCGGTC
AGAATGATTTCGCATTCGA -> GAATGATTTCGCATTCGAA
AGAATTATCTTGAAGAGGT -> GAATTATCTTGAAGAGGTA
AGACAATAAACACGGTGGG -> GACAATAAACACGGTGGGC
AGACACCAGATCCCTTTAC -> GACACCAGATCCCTTTACC
AGACACGTGCTTAGACACC -> GACACGTGCTTAGACACCA
AGACCTCTTTATTCGGGGA -> GACCTCTTTATTCGGGGAA
AGACGCAGTAATCCAGGAA -> GACGCAGTAATCCAGGAAG
AGACGTGAACCGTACTTAC -> GACGTGAACCGTACTTACA
AGACTTAGCGCCACCGCCC -> GACTTAGCGCCACCGCCCT
AGACTTGTATGATCTCGCC -> GACTTGTATGATCTCGCCT
AGACTTTAGTGGGTTGCAG -> GACTTTAGTGGGTTGCAGT
AGAGAAGTAAGTAAGTCGC -> GAGAAGTAAGTAAGTCGCC
AGAGACTTAGCGCCACCGC -> GAGACTTAGCGCCACCGCC
AGAGATCGCGCTAGCGCAG -> GAGATCGCGCTAGCGCAGC
AGAGATCGGGGATTATGTG -> GAGATCGGGGATTATGTGC
AGAGCGAAGACGTGAACCG -> GAGCGAAGACGTGAACCGT
AGAGCGCAAAGCGCTAAGC -> GAGCGCAAAGCGCTAAGCG
AGAGCTAGGCTTCGCCGAA -> GAGCTAGGCTTCGCCGAAT
AGAGCTGGCCCACGAGTTC -> GAGCTGGCCCACGAGTTCG
AGAGGGCAGCCAACTCATG -> GAGGGCAGCCAACTCATGA
AGAGGTAGTCCTCAGAGGG -> GAGGTAGTCCTCAGAGGGC
AGAGTAATAGTGACCGGGA -> GAGTAATAGTGACCGGGAT
AGAGTTCACTTGAAGGCCC -> GAGTTCACTTGAAGGCCCG
AGATCCCCGATTCAATCTC -> GATCCCCGATTCAATCTCG
AGATCCCTTTACCGCGGGA -> GATCCCTTTACCGCGGGAG
AGATCGCGCTAGCGCAGCT -> GATCGCGCTAGCGCAGCTC
AGATCGGGGATTATGTGCT -> GATCGGGGATTATGTGCTA
AGATCTTCTGTATCAACTT -> GATCTTCTGTATCAACTTT
AGATGAGCCCTCCCACAGA -> GATGAGCCCTCCCACAGAT
AGATGGTGTGACGGATAGC -> GATGGTGTGACGGATAGCA
AGATGTAGTCGCCAAGACA -> GATGTAGTCGCCAAGACAC
AGATTAAGCGGGTAGGTGA -> GATTAAGCGGGTAGGTGAT
AGATTGACCCGCCCTATAA -> GATTGACCCGCCCTATAAC
AGATTGATGAGAATAGGTA -> GATTGATGAGAATAGGTAG
AGATTGCGGTGGGCGTTCC -> GATTGCGGTGGGCGTTCCG
AGCAACTACGGCCTCATTG -> GCAACTACGGCCTCATTGT
AGCACGTTAGGCCAACCGT -> GCACGTTAGGCCAACCGTT
AGCAGTATAGCGTTAGTTG -> GCAGTATAGCGTTAGTTGG
AGCATGAGGATCCGGGAGA -> GCATGAGGATCCGGGAGAG
AGCCAACTCATGAGGACTC -> GCCAACTCATGAGGACTCC
AGCCCTCCCACAGATCCCC -> GCCCTCCCACAGATCCCCG
AGCCTCGTGTCGAACAAAG -> GCCTCGTGTCGAACAAAGA
AGCCTGGGTAAAAGGTGGG -> GCCTGGGTAAAAGGTGGGC
AGCGAACTCCTCACGCACC -> GCGAACTCCTCACGCACCT
AGCGAAGACGTGAACCGTA -> GCGAAGACGTGAACCGTAC
AGCGCAAAGCGCTAAGCGG -> GCGCAAAGCGCTAAGCGGC
AGCGCAGCTCGCCAAGGTC -> GCGCAGCTCGCCAAGGTCC
AGCGCCACCGCCCTGCGTC -> GCGCCACCGCCCTGCGTCC
AGCGCCGCGCAACAAGTGT -> GCGCCGCGCAACAAGTGTC
AGCGCCGCTCACATGTTGC -> GCGCCGCTCACATGTTGCC
AGCGCTAAGCGGCTGAATC -> GCGCTAAGCGGCTGAATCG
AGCGGCTGAATCGCAAAGA -> GCGGCTGAATCGCAAAGAG
AGCGGGTAGGTGATCCTGT -> GCGGGTAGGTGATCCTGTA
AGCGTTAGTTGGGCTTACG -> GCGTTAGTTGGGCTTACGA
AGCTAGGCTTCGCCGAATA -> GCTAGGCTTCGCCGAATAT
AGCTCGCCAAGGTCCGGAG -> GCTCGCCAAGGTCCGGAGG
AGCTCTTACACAGATGGTG -> GCTCTTACACAGATGGTGT
AGCTCTTACACCCACAGCT -> GCTCTTACACCCACAGCTC
AGCTCTTACACGCCACAGC -> GCTCTTACACGCCACAGCT
AGCTCTTACACTTCGGGGA -> GCTCTTACACTTCGGGGAA
AGCTGGCCCACGAGTTCGT -> GCTGGCCCACGAGTTCGTT
AGGAAAACTCCTATTGCCA -> GGAAAACTCCTATTGCCAC
AGGAAGAACAAAAGAGATC -> GGAAGAACAAAAGAGATCG
AGGACTCCGTGGGAAACTT -> GGACTCCGTGGGAAACTTT
AGGACTTTCAGATTAAGCG -> GGACTTTCAGATTAAGCGG
AGGATCCGGGAGAGTAATA -> GGATCCGGGAGAGTAATAG
AGGATGCTATCGCTAGGCG -> GGATGCTATCGCTAGGCGA
AGGCAAAGTTGAATTCATT -> GGCAAAGTTGAATTCATTG
AGGCAATGCTAAGCACGTT -> GGCAATGCTAAGCACGTTA
AGGCACGTGGGTTCATTCC -> GGCACGTGGGTTCATTCCC
AGGCCAACCGTTTAATCTG -> GGCCAACCGTTTAATCTGG
AGGCCCGAGGTAACCTAAT -> GGCCCGAGGTAACCTAATA
AGGCCTAATCTCTACCCAC -> GGCCTAATCTCTACCCACT
AGGCGATGCTGTGATCGCT -> GGCGATGCTGTGATCGCTT
AGGCTAACGCGGGAAACGT -> GGCTAACGCGGGAAACGTC
AGGCTTCGCCGAATATATC -> GGCTTCGCCGAATATATCC
AGGGACAGATGTAGTCGCC -> GGGACAGATGTAGTCGCCA
AGGGAGTACTCACATGATT -> GGGAGTACTCACATGATTC
AGGGAGTGATATCTGCCAA -> GGGAGTGATATCTGCCAAG
AGGGATCAGCGCCGCTCAC -> GGGATCAGCGCCGCTCACA
AGGGCAGCCAACTCATGAG -> GGGCAGCCAACTCATGAGG
AGGGCGGTCCGGTGTCCAC -> GGGCGGTCCGGTGTCCACA
AGGGCTGTGGTAAATGCTA -> GGGCTGTGGTAAATGCTAA
AGGGTACCTGTCTCTCCGA -> GGGTACCTGTCTCTCCGAG
AGGTAACCTAATATTTCGA -> GGTAACCTAATATTTCGAG
AGGTAGTCCTCAGAGGGCA -> GGTAGTCCTCAGAGGGCAG
AGGTAGTTCTGCGTAAGTC -> GGTAGTTCTGCGTAAGTCA
AGGTCAATTATTGATGACG -> GGTCAATTATTGATGACGA
AGGTCCGGAGGTTTAAAAG -> GGTCCGGAGGTTTAAAAGG
AGGTGAATACGTCACACCT -> GGTGAATACGTCACACCTC
AGGTGATCCTGTAACCACC -> GGTGATCCTGTAACCACCG
AGGTGGGCGTGTCTTCGAT -> GGTGGGCGTGTCTTCGATC
AGGTTTAAAAGGACTTTCA -> GGTTTAAAAGGACTTTCAG
AGGTTTGCAATGTTACGGG -> GGTTTGCAATGTTACGGGT
AGTAAGAGACTTAGCGCCA -> GTAAGAGACTTAGCGCCAC
AGTAAGTAAGAGACTTAGC -> GTAAGTAAGAGACTTAGCG
AGTAAGTAAGTCGCCAATG -> GTAAGTAAGTCGCCAATGC
AGTAAGTCGCCAATGCCTA -> GTAAGTCGCCAATGCCTAC
AGTAATAGTGACCGGGATG -> GTAATAGTGACCGGGATGG
AGTAATCCAGGAAGAACAA -> GTAATCCAGGAAGAACAAA
AGTACTCACATGATTCTTC -> GTACTCACATGATTCTTCA
AGTACTCTTGCCATTACCT -> GTACTCTTGCCATTACCTT
AGTAGGGTACCTGTCTCTC -> GTAGGGTACCTGTCTCTCC
AGTATAGCGTTAGTTGGGC -> GTATAGCGTTAGTTGGGCT
AGTCACTCGGACTGTTCGA -> GTCACTCGGACTGTTCGAG
AGTCAGAGTTCACTTGAAG -> GTCAGAGTTCACTTGAAGG
AGTCAGATTGACCCGCCCT -> GTCAGATTGACCCGCCCTA
AGTCCTCAGAGGGCAGCCA -> GTCCTCAGAGGGCAGCCAA
AGTCGATGGCAGATTGATG -> GTCGATGGCAGATTGATGA
AGTCGCCAAGACACGTGCT -> GTCGCCAAGACACGTGCTT
AGTCGCCAATGCCTACGGA -> GTCGCCAATGCCTACGGAC
AGTCGGCAGGGACAGATGT -> GTCGGCAGGGACAGATGTA
AGTCTAAGTGTCCGATTGT -> GTCTAAGTGTCCGATTGTT
AGTGAAGAATCTTTGAAGG -> GTGAAGAATCTTTGAAGGG
AGTGACCGGGATGGTCTGA -> GTGACCGGGATGGTCTGAG
AGTGACGTCCAGTCGATGG -> GTGACGTCCAGTCGATGGC
AGTGATAGTCACTCGGACT -> GTGATAGTCACTCGGACTG
AGTGATATCTGCCAAGAAT -> GTGATATCTGCCAAGAATG
AGTGGAGAGCTAGGCTTCG -> GTGGAGAGCTAGGCTTCGC
AGTGGGTTGCAGTCTAAGT -> GTGGGTTGCAGTCTAAGTG
AGTGTCCGATTGTTATACG -> GTGTCCGATTGTTATACGA
AGTGTCCGCGAGTTGGCGC -> GTGTCCGCGAGTTGGCGCC
AGTTAATACTAGCCTGGGT -> GTTAATACTAGCCTGGGTA
AGTTCAAATTGTATCATGC -> GTTCAAATTGTATCATGCC
AGTTCACTTGAAGGCCCGA -> GTTCACTTGAAGGCCCGAG
AGTTCGTTGCGGTTCATCC -> GTTCGTTGCGGTTCATCCG
AGTTCTGCGTAAGTCAGAG -> GTTCTGCGTAAGTCAGAGT
AGTTGAATTCATTGCGGGA -> GTTGAATTCATTGCGGGAC
AGTTGCCCAAAGGCCTAAT -> GTTGCCCAAAGGCCTAATC
AGTTGGCGCCAACAATGCC -> GTTGGCGCCAACAATGCCT
AGTTGGGCTTACGAGTGAC -> GTTGGGCTTACGAGTGACG
ATAAACACGGTGGGCGTTC -> TAAACACGGTGGGCGTTCC
ATAAAGTAAGTAAGAGACT -> TAAAGTAAGTAAGAGACTT
ATAACGTGCAAAATATTGT -> TAACGTGCAAAATATTGTC
ATAACTGATGGTGATTTTG -> TAACTGATGGTGATTTTGT
ATAATTGCCACAGCTCTTA -> TAATTGCCACAGCTCTTAC
ATACATTCCGTAGGTCAAT -> TACATTCCGTAGGTCAATT
ATACCGGGAACCCTAGGGA -> TACCGGGAACCCTAGGGAG
ATACGAGCCTCGTGTCGAA -> TACGAGCCTCGTGTCGAAC
ATACGTCACACCTCGGTTT -> TACGTCACACCTCGGTTTA
ATACTAGCCTGGGTAAAAG -> TACTAGCCTGGGTAAAAGG
ATACTCACCGGGTGACTAT -> TACTCACCGGGTGACTATT
ATACTTTTACTCAGATTGC -> TACTTTTACTCAGATTGCG
ATAGCAGTATAGCGTTAGT -> TAGCAGTATAGCGTTAGTT
ATAGCGTTAGTTGGGCTTA -> TAGCGTTAGTTGGGCTTAC
ATAGGAAAACTCCTATTGC -> TAGGAAAACTCCTATTGCC
ATAGGGCTGTGGTAAATGC -> TAGGGCTGTGGTAAATGCT
ATAGGTAGTTCTGCGTAAG -> TAGGTAGTTCTGCGTAAGT
ATAGGTTTGCAATGTTACG -> TAGGTTTGCAATGTTACGG
ATAGTCACTCGGACTGTTC -> TAGTCACTCGGACTGTTCG
ATAGTGACCGGGATGGTCT -> TAGTGACCGGGATGGTCTG
ATATAATTGCCACAGCTCT -> TATAATTGCCACAGCTCTT
ATATATCCTTCAGACAATA -> TATATCCTTCAGACAATAA
ATATCATCCATATAATTGC -> TATCATCCATATAATTGCC
ATATCCTTCAGACAATAAA -> TATCCTTCAGACAATAAAC
ATATCTGCCAAGAATGATT -> TATCTGCCAAGAATGATTT
ATATTCAAGAAATAGGTTT -> TATTCAAGAAATAGGTTTG
ATATTGTCGGTGGGCGTTC -> TATTGTCGGTGGGCGTTCC
ATATTTCGAGAGATCGCGC -> TATTTCGAGAGATCGCGCT
ATCAACTTTAGGCAATGCT -> TCAACTTTAGGCAATGCTA
ATCAAGCGAACTCCTCACG -> TCAAGCGAACTCCTCACGC
ATCAATTGAAATTAGAGCT -> TCAATTGAAATTAGAGCTG
ATCACACGACTGGAGTAGG -> TCACACGACTGGAGTAGGG
ATCAGCGCCGCTCACATGT -> TCAGCGCCGCTCACATGTT
ATCATCCATATAATTGCCA -> TCATCCATATAATTGCCAC
ATCATCGTGGCGTAGCGCC -> TCATCGTGGCGTAGCGCCG
ATCATGCCGGGAGTTGCCC -> TCATGCCGGGAGTTGCCCA
ATCCAGGAAGAACAAAAGA -> TCCAGGAAGAACAAAAGAG
ATCCATATAATTGCCACAG -> TCCATATAATTGCCACAGC
ATCCCCGATTCAATCTCGG -> TCCCCGATTCAATCTCGGT
ATCCCTCTTGGTTATTCGT -> TCCCTCTTGGTTATTCGTC
ATCCCTTTACCGCGGGAGA -> TCCCTTTACCGCGGGAGAA
ATCCGGGAGAGTAATAGTG -> TCCGGGAGAGTAATAGTGA
ATCCGGTGGGCGTTCCGAA -> TCCGGTGGGCGTTCCGAAT
ATCCTGTAACCACCGTATA -> TCCTGTAACCACCGTATAA
ATCCTTCAGACAATAAACA -> TCCTTCAGACAATAAACAC
ATCCTTGCAATGCAAAAGA -> TCCTTGCAATGCAAAAGAG
ATCGACCCAACCGCCGCCG -> TCGACCCAACCGCCGCCGT
ATCGACTACATTGATTTTC -> TCGACTACATTGATTTTCG
ATCGCAAAGAGCGAAGACG -> TCGCAAAGAGCGAAGACGT
ATCGCGCTAGCGCAGCTCG -> TCGCGCTAGCGCAGCTCGC
ATCGCTAGGCGATGCTGTG -> TCGCTAGGCGATGCTGTGA
ATCGCTTGCACACCATGTC -> TCGCTTGCACACCATGTCG
ATCGGGGATTATGTGCTAC -> TCGGGGATTATGTGCTACT
ATCGTGGCGTAGCGCCGCG -> TCGTGGCGTAGCGCCGCGC
ATCTACTCCCCAAGTGGAG -> TCTACTCCCCAAGTGGAGA
ATCTCGCCTATCCTTGCAA -> TCTCGCCTATCCTTGCAAT
ATCTCGGTCCCTGGAAACT -> TCTCGGTCCCTGGAAACTT
ATCTCTACCCACTTTCAGG -> TCTCTACCCACTTTCAGGG
ATCTGCCAAGAATGATTTC -> TCTGCCAAGAATGATTTCG
ATCTGGATCTACTCCCCAA -> TCTGGATCTACTCCCCAAG
ATCTTCTGTATCAACTTTA -> TCTTCTGTATCAACTTTAG
ATCTTGAAGAGGTAGTCCT -> TCTTGAAGAGGTAGTCCTC
ATCTTTGAAGGGCGGTCCG -> TCTTTGAAGGGCGGTCCGG
ATCTTTTCCTAACTCCTTG -> TCTTTTCCTAACTCCTTGT
ATGAATTTATACTCACCGG -> TGAATTTATACTCACCGGG
ATGACAACAGTACTCTTGC -> TGACAACAGTACTCTTGCC
ATGACCGTACAGGCAAAGT -> TGACCGTACAGGCAAAGTT
ATGACGACAACATACCGGG -> TGACGACAACATACCGGGA
ATGAGAATAGGTAGTTCTG -> TGAGAATAGGTAGTTCTGC
ATGAGCCCTCCCACAGATC -> TGAGCCCTCCCACAGATCC
ATGAGGACTCCGTGGGAAA -> TGAGGACTCCGTGGGAAAC
ATGAGGATCCGGGAGAGTA -> TGAGGATCCGGGAGAGTAA
ATGATCTCGCCTATCCTTG -> TGATCTCGCCTATCCTTGC
ATGATTCTTCATCACACGA -> TGATTCTTCATCACACGAC
ATGATTTCGCATTCGAATG -> TGATTTCGCATTCGAATGG
ATGCAAAAGAGAAGTAAGT -> TGCAAAAGAGAAGTAAGTA
ATGCAAGACTTGTATGATC -> TGCAAGACTTGTATGATCT
ATGCCGGGAGTTGCCCAAA -> TGCCGGGAGTTGCCCAAAG
ATGCCTACGGACTGTTACA -> TGCCTACGGACTGTTACAC
ATGCCTGTCCGTTCAAAGT -> TGCCTGTCCGTTCAAAGTG
ATGCGGTTTGGGGTAGGCA -> TGCGGTTTGGGGTAGGCAC
ATGCGTTTGTACGTAGAAC -> TGCGTTTGTACGTAGAACT
ATGCTAAGCACGTTAGGCC -> TGCTAAGCACGTTAGGCCA
ATGCTAATGGTTGATGACC -> TGCTAATGGTTGATGACCG
ATGCTATCGCTAGGCGATG -> TGCTATCGCTAGGCGATGC
ATGCTGTGATCGCTTGCAC -> TGCTGTGATCGCTTGCACA
ATGGCAGATTGATGAGAAT -> TGGCAGATTGATGAGAATA
ATGGCCAACGGAAACCGAG -> TGGCCAACGGAAACCGAGT
ATGGTCTGAGTCGGCAGGG -> TGGTCTGAGTCGGCAGGGA
ATGGTGATTTTGTACGTCG -> TGGTGATTTTGTACGTCGG
ATGGTGTGACGGATAGCAG -> TGGTGTGACGGATAGCAGT
ATGGTTGATGACCGTACAG -> TGGTTGATGACCGTACAGG
ATGTAGTCGCCAAGACACG -> TGTAGTCGCCAAGACACGT
ATGTCGCAACGCTCAGAGC -> TGTCGCAACGCTCAGAGCG
ATGTGCTACTTTTCTCAAC -> TGTGCTACTTTTCTCAACG
ATGTTACGGGTACAGAAGG -> TGTTACGGGTACAGAAGGA
ATGTTGCCAGCAACTACGG -> TGTTGCCAGCAACTACGGC
ATTAAGCGGGTAGGTGATC -> TTAAGCGGGTAGGTGATCC
ATTACCTGGAGATCTTCTG -> TTACCTGGAGATCTTCTGT
ATTACCTTCAACTTAACAG -> TTACCTTCAACTTAACAGG
ATTAGAGCTGGCCCACGAG -> TTAGAGCTGGCCCACGAGT
ATTATCTTGAAGAGGTAGT -> TTATCTTGAAGAGGTAGTC
ATTATGTGCTACTTTTCTC -> TTATGTGCTACTTTTCTCA
ATTATTGATGACGACAACA -> TTATTGATGACGACAACAT
ATTCAAGAAATAGGTTTGC -> TTCAAGAAATAGGTTTGCA
ATTCAATCTCGGTCCCTGG -> TTCAATCTCGGTCCCTGGA
ATTCATTGCGGGACCTTCG -> TTCATTGCGGGACCTTCGG
ATTCCCCATGAATTTATAC -> TTCCCCATGAATTTATACT
ATTCCGTAGGTCAATTATT -> TTCCGTAGGTCAATTATTG
ATTCGAATGGCCAACGGAA -> TTCGAATGGCCAACGGAAA
ATTCGGGGAATACATTCCG -> TTCGGGGAATACATTCCGT
ATTCTTCATCACACGACTG -> TTCTTCATCACACGACTGG
ATTGAAATTAGAGCTGGCC -> TTGAAATTAGAGCTGGCCC
ATTGACCCGCCCTATAACT -> TTGACCCGCCCTATAACTG
ATTGATGACGACAACATAC -> TTGATGACGACAACATACC
ATTGATGAGAATAGGTAGT -> TTGATGAGAATAGGTAGTT
ATTGATTTTCGTTGCCCAG -> TTGATTTTCGTTGCCCAGG
ATTGCCACAGCTCTTACAC -> TTGCCACAGCTCTTACACC,TTGCCACAGCTCTTACACG
ATTGCGGGACCTTCGGTGT -> TTGCGGGACCTTCGGTGTG
ATTGCGGTGGGCGTTCCGA -> TTGCGGTGGGCGTTCCGAA
ATTGGATGCGTTTGTACGT -> TTGGATGCGTTTGTACGTA
ATTGTATCATGCCGGGAGT -> TTGTATCATGCCGGGAGTT
ATTGTCGGTGGGCGTTCCG -> TTGTCGGTGGGCGTTCCGA
ATTGTTATACGAGCCTCGT -> TTGTTATACGAGCCTCGTG
ATTGTTGACAATTTCATCA -> TTGTTGACAATTTCATCAT
ATTTATACTCACCGGGTGA -> TTTATACTCACCGGGTGAC
ATTTCATCATCGTGGCGTA -> TTTCATCATCGTGGCGTAG
ATTTCGAGAGATCGCGCTA -> TTTCGAGAGATCGCGCTAG
ATTTCGCATTCGAATGGCC -> TTTCGCATTCGAATGGCCA
ATTTCGCTCGTGCCTGGCT -> TTTCGCTCGTGCCTGGCTT
ATTTTCGTTGCCCAGGGAT -> TTTTCGTTGCCCAGGGATC
ATTTTGTACGTCGGTACGT -> TTTTGTACGTCGGTACGTA
CAAAAGAACCGTACCGGTA -> AAAAGAACCGTACCGGTAG
CAAAAGAGAAGTAAGTAAG -> AAAAGAGAAGTAAGTAAGT
CAAAAGAGATCGGGGATTA -> AAAAGAGATCGGGGATTAT
CAAAATATTGTCGGTGGGC -> AAAATATTGTCGGTGGGCG
CAAAGACGCAGTAATCCAG -> AAAGACGCAGTAATCCAGG
CAAAGACTTTAGTGGGTTG -> AAAGACTTTAGTGGGTTGC
CAAAGAGCGAAGACGTGAA -> AAAGAGCGAAGACGTGAAC
CAAAGCGCTAAGCGGCTGA -> AAAGCGCTAAGCGGCTGAA
CAAAGGCCTAATCTCTACC -> AAAGGCCTAATCTCTACCC
CAAAGTGAAGAATCTTTGA -> AAAGTGAAGAATCTTTGAA
CAAAGTGATAGTCACTCGG -> AAAGTGATAGTCACTCGGA
CAAAGTTGAATTCATTGCG -> AAAGTTGAATTCATTGCGG
CAAATTGTATCATGCCGGG -> AAATTGTATCATGCCGGGA
CAACAAGTGTCCGCGAGTT -> AACAAGTGTCCGCGAGTTG
CAACAATGCCTGTCCGTTC -> AACAATGCCTGTCCGTTCA
CAACAGTACTCTTGCCATT -> AACAGTACTCTTGCCATTA
CAACATACCGGGAACCCTA -> AACATACCGGGAACCCTAG
CAACCGCCGCCGTGATCGA -> AACCGCCGCCGTGATCGAC
CAACCGTTTAATCTGGATC -> AACCGTTTAATCTGGATCT
CAACGACCATTTCGCTCGT -> AACGACCATTTCGCTCGTG
CAACGCTCAGAGCGCAAAG -> AACGCTCAGAGCGCAAAGC
CAACGGAAACCGAGTCAGA -> AACGGAAACCGAGTCAGAT
CAACTACGGCCTCATTGTT -> AACTACGGCCTCATTGTTG
CAACTCATGAGGACTCCGT -> AACTCATGAGGACTCCGTG
CAACTTAACAGGTGAATAC -> AACTTAACAGGTGAATACG
CAACTTTAGGCAATGCTAA -> AACTTTAGGCAATGCTAAG
CAAGAAATAGGTTTGCAAT -> AAGAAATAGGTTTGCAATG
CAAGAATGATTTCGCATTC -> AAGAATGATTTCGCATTCG
CAAGACACGTGCTTAGACA -> AAGACACGTGCTTAGACAC
CAAGACTTGTATGATCTCG -> AAGACTTGTATGATCTCGC
CAAGCGAACTCCTCACGCA -> AAGCGAACTCCTCACGCAC
CAAGGTCCGGAGGTTTAAA -> AAGGTCCGGAGGTTTAAAA
CAAGTGGAGAGCTAGGCTT -> AAGTGGAGAGCTAGGCTTC
CAAGTGTCCGCGAGTTGGC -> AAGTGTCCGCGAGTTGGCG
CAATAAACACGGTGGGCGT -> AATAAACACGGTGGGCGTT
CAATCAATTGAAATTAGAG -> AATCAATTGAAATTAGAGC
CAATCTCGGTCCCTGGAAA -> AATCTCGGTCCCTGGAAAC
CAATGCAAAAGAGAAGTAA -> AATGCAAAAGAGAAGTAAG
CAATGCCTACGGACTGTTA -> AATGCCTACGGACTGTTAC
CAATGCCTGTCCGTTCAAA -> AATGCCTGTCCGTTCAAAG
CAATGCTAAGCACGTTAGG -> AATGCTAAGCACGTTAGGC
CAATGTTACGGGTACAGAA -> AATGTTACGGGTACAGAAG
CAATTATTGATGACGACAA -> AATTATTGATGACGACAAC
CAATTGAAATTAGAGCTGG -> AATTGAAATTAGAGCTGGC
CAATTTCATCATCGTGGCG -> AATTTCATCATCGTGGCGT
CACAATCAATTGAAATTAG -> ACAATCAATTGAAATTAGA
CACACCATGTCGCAACGCT -> ACACCATGTCGCAACGCTC
CACACCTCGGTTTAGTTAA -> ACACCTCGGTTTAGTTAAT
CACACGACTGGAGTAGGGT -> ACACGACTGGAGTAGGGTA
CACACTGGACTACAAAGAC -> ACACTGGACTACAAAGACT
CACAGATCCCCGATTCAAT -> ACAGATCCCCGATTCAATC
CACAGATGGTGTGACGGAT -> ACAGATGGTGTGACGGATA
CACAGCTCTTACACAGATG -> ACAGCTCTTACACAGATGG
CACAGCTCTTACACCCACA -> ACAGCTCTTACACCCACAG
CACAGCTCTTACACGCCAC -> ACAGCTCTTACACGCCACA
CACAGCTCTTACACTTCGG -> ACAGCTCTTACACTTCGGG
CACATGATTCTTCATCACA -> ACATGATTCTTCATCACAC
CACATGCGGTTTGGGGTAG -> ACATGCGGTTTGGGGTAGG
CACATGTTGCCAGCAACTA -> ACATGTTGCCAGCAACTAC
CACCACACTGGACTACAAA -> ACCACACTGGACTACAAAG
CACCAGATCCCTTTACCGC -> ACCAGATCCCTTTACCGCG
CACCATCGACCCAACCGCC -> ACCATCGACCCAACCGCCG
CACCATGTCGCAACGCTCA -> ACCATGTCGCAACGCTCAG
CACCCACAGCTCTTACACA -> ACCCACAGCTCTTACACAG
CACCGCCCTGCGTCCAAAA -> ACCGCCCTGCGTCCAAAAG
CACCGGGTGACTATTGGAT -> ACCGGGTGACTATTGGATG
CACCGTATAAAGTAAGTAA -> ACCGTATAAAGTAAGTAAG
CACCTCCCGGTAATCTTTT -> ACCTCCCGGTAATCTTTTC
CACCTCGGTTTAGTTAATA -> ACCTCGGTTTAGTTAATAC
CACGACTGGAGTAGGGTAC -> ACGACTGGAGTAGGGTACC
CACGAGTTCGTTGCGGTTC -> ACGAGTTCGTTGCGGTTCA
CACGCACCTCCCGGTAATC -> ACGCACCTCCCGGTAATCT
CACGCCACAGCTCTTACAC -> ACGCCACAGCTCTTACACT
CACGGTGGGCGTTCCGAAT -> ACGGTGGGCGTTCCGAATA
CACGTGCTTAGACACCAGA -> ACGTGCTTAGACACCAGAT
CACGTGGGTTCATTCCCCA -> ACGTGGGTTCATTCCCCAT
CACGTTAGGCCAACCGTTT -> ACGTTAGGCCAACCGTTTA
CACTCGGACTGTTCGAGGC -> ACTCGGACTGTTCGAGGCT
CACTCTTCACATGCGGTTT -> ACTCTTCACATGCGGTTTG
CACTGGACTACAAAGACTT -> ACTGGACTACAAAGACTTT
CACTTCGGGGAAGTTCAAA -> ACTTCGGGGAAGTTCAAAT
CACTTGAAGGCCCGAGGTA -> ACTTGAAGGCCCGAGGTAA
CACTTTCAGGGAGTACTCA -> ACTTTCAGGGAGTACTCAC
CAGAAGGATGCTATCGCTA -> AGAAGGATGCTATCGCTAG
CAGACAATAAACACGGTGG -> AGACAATAAACACGGTGGG
CAGAGCGCAAAGCGCTAAG -> AGAGCGCAAAGCGCTAAGC
CAGAGGGCAGCCAACTCAT -> AGAGGGCAGCCAACTCATG
CAGAGTTCACTTGAAGGCC -> AGAGTTCACTTGAAGGCCC
CAGATCCCCGATTCAATCT -> AGATCCCCGATTCAATCTC
CAGATCCCTTTACCGCGGG -> AGATCCCTTTACCGCGGGA
CAGATGGTGTGACGGATAG -> AGATGGTGTGACGGATAGC
CAGATGTAGTCGCCAAGAC -> AGATGTAGTCGCCAAGACA
CAGATTAAGCGGGTAGGTG -> AGATTAAGCGGGTAGGTGA
CAGATTGACCCGCCCTATA -> AGATTGACCCGCCCTATAA
CAGATTGATGAGAATAGGT -> AGATTGATGAGAATAGGTA
CAGATTGCGGTGGGCGTTC -> AGATTGCGGTGGGCGTTCC
CAGCAACTACGGCCTCATT -> AGCAACTACGGCCTCATTG
CAGCATGAGGATCCGGGAG -> AGCATGAGGATCCGGGAGA
CAGCCAACTCATGAGGACT -> AGCCAACTCATGAGGACTC
CAGCGCCGCTCACATGTTG -> AGCGCCGCTCACATGTTGC
CAGCTCGCCAAGGTCCGGA -> AGCTCGCCAAGGTCCGGAG
CAGCTCTTACACAGATGGT -> AGCTCTTACACAGATGGTG
CAGCTCTTACACCCACAGC -> AGCTCTTACACCCACAGCT
CAGCTCTTACACGCCACAG -> AGCTCTTACACGCCACAGC
CAGCTCTTACACTTCGGGG -> AGCTCTTACACTTCGGGGA
CAGGAAGAACAAAAGAGAT -> AGGAAGAACAAAAGAGATC
CAGGCAAAGTTGAATTCAT -> AGGCAAAGTTGAATTCATT
CAGGGACAGATGTAGTCGC -> AGGGACAGATGTAGTCGCC
CAGGGAGTACTCACATGAT -> AGGGAGTACTCACATGATT
CAGGGATCAGCGCCGCTCA -> AGGGATCAGCGCCGCTCAC
CAGGTGAATACGTCACACC -> AGGTGAATACGTCACACCT
CAGTAATCCAGGAAGAACA -> AGTAATCCAGGAAGAACAA
CAGTACTCTTGCCATTACC -> AGTACTCTTGCCATTACCT
CAGTATAGCGTTAGTTGGG -> AGTATAGCGTTAGTTGGGC
CAGTCGATGGCAGATTGAT -> AGTCGATGGCAGATTGATG
CAGTCTAAGTGTCCGATTG -> AGTCTAAGTGTCCGATTGT
CATACCGGGAACCCTAGGG -> ATACCGGGAACCCTAGGGA
CATATAATTGCCACAGCTC -> ATATAATTGCCACAGCTCT
CATCACACGACTGGAGTAG -> ATCACACGACTGGAGTAGG
CATCATCGTGGCGTAGCGC -> ATCATCGTGGCGTAGCGCC
CATCCATATAATTGCCACA -> ATCCATATAATTGCCACAG
CATCCGGTGGGCGTTCCGA -> ATCCGGTGGGCGTTCCGAA
CATCGACCCAACCGCCGCC -> ATCGACCCAACCGCCGCCG
CATCGTGGCGTAGCGCCGC -> ATCGTGGCGTAGCGCCGCG
CATGAATTTATACTCACCG -> ATGAATTTATACTCACCGG
CATGACAACAGTACTCTTG -> ATGACAACAGTACTCTTGC
CATGAGGACTCCGTGGGAA -> ATGAGGACTCCGTGGGAAA
CATGAGGATCCGGGAGAGT -> ATGAGGATCCGGGAGAGTA
CATGATTCTTCATCACACG -> ATGATTCTTCATCACACGA
CATGCCGGGAGTTGCCCAA -> ATGCCGGGAGTTGCCCAAA
CATGCGGTTTGGGGTAGGC -> ATGCGGTTTGGGGTAGGCA
CATGTCGCAACGCTCAGAG -> ATGTCGCAACGCTCAGAGC
CATGTTGCCAGCAACTACG -> ATGTTGCCAGCAACTACGG
CATTACCTTCAACTTAACA -> ATTACCTTCAACTTAACAG
CATTCCCCATGAATTTATA -> ATTCCCCATGAATTTATAC
CATTCCGTAGGTCAATTAT -> ATTCCGTAGGTCAATTATT
CATTCGAATGGCCAACGGA -> ATTCGAATGGCCAACGGAA
CATTGATTTTCGTTGCCCA -> ATTGATTTTCGTTGCCCAG
CATTGCGGGACCTTCGGTG -> ATTGCGGGACCTTCGGTGT
CATTGTTGACAATTTCATC -> ATTGTTGACAATTTCATCA
CATTTCGCTCGTGCCTGGC -> ATTTCGCTCGTGCCTGGCT
CCAAAAGAACCGTACCGGT -> CAAAAGAACCGTACCGGTA
CCAAAGGCCTAATCTCTAC -> CAAAGGCCTAATCTCTACC
CCAACAATGCCTGTCCGTT -> CAACAATGCCTGTCCGTTC
CCAACCGCCGCCGTGATCG -> CAACCGCCGCCGTGATCGA
CCAACCGTTTAATCTGGAT -> CAACCGTTTAATCTGGATC
CCAACGGAAACCGAGTCAG -> CAACGGAAACCGAGTCAGA
CCAACTCATGAGGACTCCG -> CAACTCATGAGGACTCCGT
CCAAGAATGATTTCGCATT -> CAAGAATGATTTCGCATTC
CCAAGACACGTGCTTAGAC -> CAAGACACGTGCTTAGACA
CCAAGGTCCGGAGGTTTAA -> CAAGGTCCGGAGGTTTAAA
CCAAGTGGAGAGCTAGGCT -> CAAGTGGAGAGCTAGGCTT
CCAATGCCTACGGACTGTT -> CAATGCCTACGGACTGTTA
CCACAATCAATTGAAATTA -> CACAATCAATTGAAATTAG
CCACACTGGACTACAAAGA -> CACACTGGACTACAAAGAC
CCACAGATCCCCGATTCAA -> CACAGATCCCCGATTCAAT
CCACAGCTCTTACACAGAT -> CACAGCTCTTACACAGATG
CCACAGCTCTTACACCCAC -> CACAGCTCTTACACCCACA
CCACAGCTCTTACACGCCA -> CACAGCTCTTACACGCCAC
CCACAGCTCTTACACTTCG -> CACAGCTCTTACACTTCGG
CCACCGCCCTGCGTCCAAA -> CACCGCCCTGCGTCCAAAA
CCACCGTATAAAGTAAGTA -> CACCGTATAAAGTAAGTAA
CCACGAGTTCGTTGCGGTT -> CACGAGTTCGTTGCGGTTC
CCACTTTCAGGGAGTACTC -> CACTTTCAGGGAGTACTCA
CCAGATCCCTTTACCGCGG -> CAGATCCCTTTACCGCGGG
CCAGCAACTACGGCCTCAT -> CAGCAACTACGGCCTCATT
CCAGGAAGAACAAAAGAGA -> CAGGAAGAACAAAAGAGAT
CCAGGGATCAGCGCCGCTC -> CAGGGATCAGCGCCGCTCA
CCAGTCGATGGCAGATTGA -> CAGTCGATGGCAGATTGAT
CCATATAATTGCCACAGCT -> CATATAATTGCCACAGCTC
CCATCGACCCAACCGCCGC -> CATCGACCCAACCGCCGCC
CCATGAATTTATACTCACC -> CATGAATTTATACTCACCG
CCATGACAACAGTACTCTT -> CATGACAACAGTACTCTTG
CCATGTCGCAACGCTCAGA -> CATGTCGCAACGCTCAGAG
CCATTACCTTCAACTTAAC -> CATTACCTTCAACTTAACA
CCATTTCGCTCGTGCCTGG -> CATTTCGCTCGTGCCTGGC
CCCAAAGGCCTAATCTCTA -> CCAAAGGCCTAATCTCTAC
CCCAACCGCCGCCGTGATC -> CCAACCGCCGCCGTGATCG
CCCAAGTGGAGAGCTAGGC -> CCAAGTGGAGAGCTAGGCT
CCCACAGATCCCCGATTCA -> CCACAGATCCCCGATTCAA
CCCACAGCTCTTACACAGA -> CCACAGCTCTTACACAGAT
CCCACGAGTTCGTTGCGGT -> CCACGAGTTCGTTGCGGTT
CCCACTTTCAGGGAGTACT -> CCACTTTCAGGGAGTACTC
CCCAGGGATCAGCGCCGCT -> CCAGGGATCAGCGCCGCTC
CCCATGAATTTATACTCAC -> CCATGAATTTATACTCACC
CCCCAAGTGGAGAGCTAGG -> CCCAAGTGGAGAGCTAGGC
CCCCATGAATTTATACTCA -> CCCATGAATTTATACTCAC
CCCCGATTCAATCTCGGTC -> CCCGATTCAATCTCGGTCC
CCCGAGGTAACCTAATATT -> CCGAGGTAACCTAATATTT
CCCGATTCAATCTCGGTCC -> CCGATTCAATCTCGGTCCC
CCCGCCCTATAACTGATGG -> CCGCCCTATAACTGATGGT
CCCGGTAATCTTTTCCTAA -> CCGGTAATCTTTTCCTAAC
CCCTAGGGAGTGATATCTG -> CCTAGGGAGTGATATCTGC
CCCTATAACTGATGGTGAT -> CCTATAACTGATGGTGATT
CCCTCCCACAGATCCCCGA -> CCTCCCACAGATCCCCGAT
CCCTCTTGGTTATTCGTCA -> CCTCTTGGTTATTCGTCAG
CCCTGCGTCCAAAAGAACC -> CCTGCGTCCAAAAGAACCG
CCCTGGAAACTTTGGTTTT -> CCTGGAAACTTTGGTTTTT
CCCTTTACCGCGGGAGAAT -> CCTTTACCGCGGGAGAATT
CCGAATAACGTGCAAAATA -> CGAATAACGTGCAAAATAT
CCGAATACTTTTACTCAGA -> CGAATACTTTTACTCAGAT
CCGAATAGGAAAACTCCTA -> CGAATAGGAAAACTCCTAT
CCGAATATATCCTTCAGAC -> CGAATATATCCTTCAGACA
CCGAATATCATCCATATAA -> CGAATATCATCCATATAAT
CCGAGATGAGCCCTCCCAC -> CGAGATGAGCCCTCCCACA
CCGAGGTAACCTAATATTT -> CGAGGTAACCTAATATTTC
CCGAGTCAGATTGACCCGC -> CGAGTCAGATTGACCCGCC
CCGATTCAATCTCGGTCCC -> CGATTCAATCTCGGTCCCT
CCGATTGTTATACGAGCCT -> CGATTGTTATACGAGCCTC
CCGCCCTATAACTGATGGT -> CGCCCTATAACTGATGGTG
CCGCCCTGCGTCCAAAAGA -> CGCCCTGCGTCCAAAAGAA
CCGCCGCCGTGATCGACTA -> CGCCGCCGTGATCGACTAC
CCGCCGTGATCGACTACAT -> CGCCGTGATCGACTACATT
CCGCGAGTTGGCGCCAACA -> CGCGAGTTGGCGCCAACAA
CCGCGCAACAAGTGTCCGC -> CGCGCAACAAGTGTCCGCG
CCGCGGGAGAATTATCTTG -> CGCGGGAGAATTATCTTGA
CCGCTCACATGTTGCCAGC -> CGCTCACATGTTGCCAGCA
CCGGAGGTTTAAAAGGACT -> CGGAGGTTTAAAAGGACTT
CCGGGAACCCTAGGGAGTG -> CGGGAACCCTAGGGAGTGA
CCGGGAGAGTAATAGTGAC -> CGGGAGAGTAATAGTGACC
CCGGGAGTTGCCCAAAGGC -> CGGGAGTTGCCCAAAGGCC
CCGGGATGGTCTGAGTCGG -> CGGGATGGTCTGAGTCGGC
CCGGGTGACTATTGGATGC -> CGGGTGACTATTGGATGCG
CCGGGTGTATGCAAGACTT -> CGGGTGTATGCAAGACTTG
CCGGTAATCTTTTCCTAAC -> CGGTAATCTTTTCCTAACT
CCGGTAGACCTCTTTATTC -> CGGTAGACCTCTTTATTCG
CCGGTGGGCGTTCCGAATA -> CGGTGGGCGTTCCGAATAC
CCGGTGTCCACAATCAATT -> CGGTGTCCACAATCAATTG
CCGTACAGGCAAAGTTGAA -> CGTACAGGCAAAGTTGAAT
CCGTACCGGTAGACCTCTT -> CGTACCGGTAGACCTCTTT
CCGTACTTACACCACACTG -> CGTACTTACACCACACTGG
CCGTAGGTCAATTATTGAT -> CGTAGGTCAATTATTGATG
CCGTATAAAGTAAGTAAGA -> CGTATAAAGTAAGTAAGAG
CCGTCTGGATAGGGCTGTG -> CGTCTGGATAGGGCTGTGG
CCGTGATCGACTACATTGA -> CGTGATCGACTACATTGAT
CCGTGGGAAACTTTGCGCC -> CGTGGGAAACTTTGCGCCA
CCGTTCAAAGTGATAGTCA -> CGTTCAAAGTGATAGTCAC
CCGTTTAATCTGGATCTAC -> CGTTTAATCTGGATCTACT
CCTAACTCCTTGTACTAAT -> CTAACTCCTTGTACTAATA
CCTAATATTTCGAGAGATC -> CTAATATTTCGAGAGATCG
CCTAATCTCTACCCACTTT -> CTAATCTCTACCCACTTTC
CCTACGGACTGTTACACCA -> CTACGGACTGTTACACCAT
CCTAGGGAGTGATATCTGC -> CTAGGGAGTGATATCTGCC
CCTATAACTGATGGTGATT -> CTATAACTGATGGTGATTT
CCTATCCTTGCAATGCAAA -> CTATCCTTGCAATGCAAAA
CCTATTGCCACAGCTCTTA -> CTATTGCCACAGCTCTTAC
CCTCACGCACCTCCCGGTA -> CTCACGCACCTCCCGGTAA
CCTCAGAGGGCAGCCAACT -> CTCAGAGGGCAGCCAACTC
CCTCATTGTTGACAATTTC -> CTCATTGTTGACAATTTCA
CCTCCCACAGATCCCCGAT -> CTCCCACAGATCCCCGATT
CCTCCCGGTAATCTTTTCC -> CTCCCGGTAATCTTTTCCT
CCTCGGTTTAGTTAATACT -> CTCGGTTTAGTTAATACTA
CCTCGTGTCGAACAAAGAC -> CTCGTGTCGAACAAAGACG
CCTCTTGGTTATTCGTCAG -> CTCTTGGTTATTCGTCAGA
CCTCTTTATTCGGGGAATA -> CTCTTTATTCGGGGAATAC
CCTGCGTCCAAAAGAACCG -> CTGCGTCCAAAAGAACCGT
CCTGGAAACTTTGGTTTTT -> CTGGAAACTTTGGTTTTTG
CCTGGAGATCTTCTGTATC -> CTGGAGATCTTCTGTATCA
CCTGGCTTCAGCATGAGGA -> CTGGCTTCAGCATGAGGAT
CCTGGGTAAAAGGTGGGCG -> CTGGGTAAAAGGTGGGCGT
CCTGTAACCACCGTATAAA -> CTGTAACCACCGTATAAAG
CCTGTCCGTTCAAAGTGAT -> CTGTCCGTTCAAAGTGATA
CCTGTCTCTCCGAGATGAG -> CTGTCTCTCCGAGATGAGC
CCTTCAACTTAACAGGTGA -> CTTCAACTTAACAGGTGAA
CCTTCAGACAATAAACACG -> CTTCAGACAATAAACACGG
CCTTCGGTGTGTCCGGGTG -> CTTCGGTGTGTCCGGGTGT
CCTTGCAATGCAAAAGAGA -> CTTGCAATGCAAAAGAGAA
CCTTGTACTAATATTCAAG -> CTTGTACTAATATTCAAGA
CCTTTACCGCGGGAGAATT -> CTTTACCGCGGGAGAATTA
CGAACAAAGACGCAGTAAT -> GAACAAAGACGCAGTAATC
CGAACTCCTCACGCACCTC -> GAACTCCTCACGCACCTCC
CGAAGACGTGAACCGTACT -> GAAGACGTGAACCGTACTT
CGAATAACGTGCAAAATAT -> GAATAACGTGCAAAATATT
CGAATACTTTTACTCAGAT -> GAATACTTTTACTCAGATT
CGAATAGGAAAACTCCTAT -> GAATAGGAAAACTCCTATT
CGAATATATCCTTCAGACA -> GAATATATCCTTCAGACAA
CGAATATCATCCATATAAT -> GAATATCATCCATATAATT
CGAATGGCCAACGGAAACC -> GAATGGCCAACGGAAACCG
CGACAACATACCGGGAACC -> GACAACATACCGGGAACCC
CGACCATTTCGCTCGTGCC -> GACCATTTCGCTCGTGCCT
CGACCCAACCGCCGCCGTG -> GACCCAACCGCCGCCGTGA
CGACTACATTGATTTTCGT -> GACTACATTGATTTTCGTT
CGACTGGAGTAGGGTACCT -> GACTGGAGTAGGGTACCTG
CGAGAGATCGCGCTAGCGC -> GAGAGATCGCGCTAGCGCA
CGAGATGAGCCCTCCCACA -> GAGATGAGCCCTCCCACAG
CGAGCCTCGTGTCGAACAA -> GAGCCTCGTGTCGAACAAA
CGAGGCTAACGCGGGAAAC -> GAGGCTAACGCGGGAAACG
CGAGGTAACCTAATATTTC -> GAGGTAACCTAATATTTCG
CGAGTCAGATTGACCCGCC -> GAGTCAGATTGACCCGCCC
CGAGTGACGTCCAGTCGAT -> GAGTGACGTCCAGTCGATG
CGAGTTCGTTGCGGTTCAT -> GAGTTCGTTGCGGTTCATC
CGAGTTGGCGCCAACAATG -> GAGTTGGCGCCAACAATGC
CGATCCCTCTTGGTTATTC -> GATCCCTCTTGGTTATTCG
CGATGCTGTGATCGCTTGC -> GATGCTGTGATCGCTTGCA
CGATGGCAGATTGATGAGA -> GATGGCAGATTGATGAGAA
CGATTCAATCTCGGTCCCT -> GATTCAATCTCGGTCCCTG
CGATTGTTATACGAGCCTC -> GATTGTTATACGAGCCTCG
CGCAAAGAGCGAAGACGTG -> GCAAAGAGCGAAGACGTGA
CGCAAAGCGCTAAGCGGCT -> GCAAAGCGCTAAGCGGCTG
CGCAACAAGTGTCCGCGAG -> GCAACAAGTGTCCGCGAGT
CGCAACGCTCAGAGCGCAA -> GCAACGCTCAGAGCGCAAA
CGCACCTCCCGGTAATCTT -> GCACCTCCCGGTAATCTTT
CGCAGCTCGCCAAGGTCCG -> GCAGCTCGCCAAGGTCCGG
CGCAGTAATCCAGGAAGAA -> GCAGTAATCCAGGAAGAAC
CGCATTCGAATGGCCAACG -> GCATTCGAATGGCCAACGG
CGCCAACAATGCCTGTCCG -> GCCAACAATGCCTGTCCGT
CGCCAAGACACGTGCTTAG -> GCCAAGACACGTGCTTAGA
CGCCAAGGTCCGGAGGTTT -> GCCAAGGTCCGGAGGTTTA
CGCCAATGCCTACGGACTG -> GCCAATGCCTACGGACTGT
CGCCACAGCTCTTACACTT -> GCCACAGCTCTTACACTTC
CGCCACCGCCCTGCGTCCA -> GCCACCGCCCTGCGTCCAA
CGCCATGACAACAGTACTC -> GCCATGACAACAGTACTCT
CGCCCTATAACTGATGGTG -> GCCCTATAACTGATGGTGA
CGCCCTGCGTCCAAAAGAA -> GCCCTGCGTCCAAAAGAAC
CGCCGAATATATCCTTCAG -> GCCGAATATATCCTTCAGA
CGCCGCCGTGATCGACTAC -> GCCGCCGTGATCGACTACA
CGCCGCGCAACAAGTGTCC -> GCCGCGCAACAAGTGTCCG
CGCCGCTCACATGTTGCCA -> GCCGCTCACATGTTGCCAG
CGCCGTGATCGACTACATT -> GCCGTGATCGACTACATTG
CGCCTATCCTTGCAATGCA -> GCCTATCCTTGCAATGCAA
CGCGAGTTGGCGCCAACAA -> GCGAGTTGGCGCCAACAAT
CGCGCAACAAGTGTCCGCG -> GCGCAACAAGTGTCCGCGA
CGCGCTAGCGCAGCTCGCC -> GCGCTAGCGCAGCTCGCCA
CGCGGGAAACGTCGGGATT -> GCGGGAAACGTCGGGATTA
CGCGGGAGAATTATCTTGA -> GCGGGAGAATTATCTTGAA
CGCTAAGCGGCTGAATCGC -> GCTAAGCGGCTGAATCGCA
CGCTAGCGCAGCTCGCCAA -> GCTAGCGCAGCTCGCCAAG
CGCTAGGCGATGCTGTGAT -> GCTAGGCGATGCTGTGATC
CGCTCACATGTTGCCAGCA -> GCTCACATGTTGCCAGCAA
CGCTCAGAGCGCAAAGCGC -> GCTCAGAGCGCAAAGCGCT
CGCTCGTGCCTGGCTTCAG -> GCTCGTGCCTGGCTTCAGC
CGCTTGCACACCATGTCGC -> GCTTGCACACCATGTCGCA
CGGAAACCGAGTCAGATTG -> GGAAACCGAGTCAGATTGA
CGGACTGTTACACCATCGA -> GGACTGTTACACCATCGAC
CGGACTGTTCGAGGCTAAC -> GGACTGTTCGAGGCTAACG
CGGAGGTTTAAAAGGACTT -> GGAGGTTTAAAAGGACTTT
CGGATAGCAGTATAGCGTT -> GGATAGCAGTATAGCGTTA
CGGCAGGGACAGATGTAGT -> GGCAGGGACAGATGTAGTC
CGGCCTCATTGTTGACAAT -> GGCCTCATTGTTGACAATT
CGGCTGAATCGCAAAGAGC -> GGCTGAATCGCAAAGAGCG
CGGGAAACGTCGGGATTAC -> GGGAAACGTCGGGATTACC
CGGGAACCCTAGGGAGTGA -> GGGAACCCTAGGGAGTGAT
CGGGACCTTCGGTGTGTCC -> GGGACCTTCGGTGTGTCCG
CGGGAGAATTATCTTGAAG -> GGGAGAATTATCTTGAAGA
CGGGAGAGTAATAGTGACC -> GGGAGAGTAATAGTGACCG
CGGGAGTTGCCCAAAGGCC -> GGGAGTTGCCCAAAGGCCT
CGGGATGGTCTGAGTCGGC -> GGGATGGTCTGAGTCGGCA
CGGGATTACCTGGAGATCT -> GGGATTACCTGGAGATCTT
CGGGGAAGTTCAAATTGTA -> GGGGAAGTTCAAATTGTAT
CGGGGAATACATTCCGTAG -> GGGGAATACATTCCGTAGG
CGGGGATTATGTGCTACTT -> GGGGATTATGTGCTACTTT
CGGGTACAGAAGGATGCTA -> GGGTACAGAAGGATGCTAT
CGGGTAGGTGATCCTGTAA -> GGGTAGGTGATCCTGTAAC
CGGGTGACTATTGGATGCG -> GGGTGACTATTGGATGCGT
CGGGTGTATGCAAGACTTG -> GGGTGTATGCAAGACTTGT
CGGTAATCTTTTCCTAACT -> GGTAATCTTTTCCTAACTC
CGGTACGTAATCAAGCGAA -> GGTACGTAATCAAGCGAAC
CGGTAGACCTCTTTATTCG -> GGTAGACCTCTTTATTCGG
CGGTCCCTGGAAACTTTGG -> GGTCCCTGGAAACTTTGGT
CGGTCCGGTGTCCACAATC -> GGTCCGGTGTCCACAATCA
CGGTGGGCGTTCCGAATAA -> GGTGGGCGTTCCGAATAAC
CGGTGGGCGTTCCGAATAC -> GGTGGGCGTTCCGAATACT
CGGTGGGCGTTCCGAATAG -> GGTGGGCGTTCCGAATAGG
CGGTGGGCGTTCCGAATAT -> GGTGGGCGTTCCGAATATC
CGGTGTCCACAATCAATTG -> GGTGTCCACAATCAATTGA
CGGTGTGTCCGGGTGTATG -> GGTGTGTCCGGGTGTATGC
CGGTTCATCCGGTGGGCGT -> GGTTCATCCGGTGGGCGTT
CGGTTTAGTTAATACTAGC -> GGTTTAGTTAATACTAGCC
CGGTTTGGGGTAGGCACGT -> GGTTTGGGGTAGGCACGTG
CGTAAGTCAGAGTTCACTT -> GTAAGTCAGAGTTCACTTG
CGTAATCAAGCGAACTCCT -> GTAATCAAGCGAACTCCTC
CGTACAGGCAAAGTTGAAT -> GTACAGGCAAAGTTGAATT
CGTACCGGTAGACCTCTTT -> GTACCGGTAGACCTCTTTA
CGTACTTACACCACACTGG -> GTACTTACACCACACTGGA
CGTAGAACTGCTGCAAAGT -> GTAGAACTGCTGCAAAGTG
CGTAGCGCCGCGCAACAAG -> GTAGCGCCGCGCAACAAGT
CGTAGGTCAATTATTGATG -> GTAGGTCAATTATTGATGA
CGTATAAAGTAAGTAAGAG -> GTATAAAGTAAGTAAGAGA
CGTCACACCTCGGTTTAGT -> GTCACACCTCGGTTTAGTT
CGTCCAAAAGAACCGTACC -> GTCCAAAAGAACCGTACCG
CGTCCAGTCGATGGCAGAT -> GTCCAGTCGATGGCAGATT
CGTCGGGATTACCTGGAGA -> GTCGGGATTACCTGGAGAT
CGTCGGTACGTAATCAAGC -> GTCGGTACGTAATCAAGCG
CGTCTGGATAGGGCTGTGG -> GTCTGGATAGGGCTGTGGT
CGTGAACCGTACTTACACC -> GTGAACCGTACTTACACCA
CGTGATCGACTACATTGAT -> GTGATCGACTACATTGATT
CGTGCAAAATATTGTCGGT -> GTGCAAAATATTGTCGGTG
CGTGCCTGGCTTCAGCATG -> GTGCCTGGCTTCAGCATGA
CGTGCTTAGACACCAGATC -> GTGCTTAGACACCAGATCC
CGTGGCGTAGCGCCGCGCA -> GTGGCGTAGCGCCGCGCAA
CGTGGGAAACTTTGCGCCA -> GTGGGAAACTTTGCGCCAT
CGTGGGTTCATTCCCCATG -> GTGGGTTCATTCCCCATGA
CGTGTCGAACAAAGACGCA -> GTGTCGAACAAAGACGCAG
CGTGTCTTCGATCCCTCTT -> GTGTCTTCGATCCCTCTTG
CGTTAGGCCAACCGTTTAA -> GTTAGGCCAACCGTTTAAT
CGTTAGTTGGGCTTACGAG -> GTTAGTTGGGCTTACGAGT
CGTTCAAAGTGATAGTCAC -> GTTCAAAGTGATAGTCACT
CGTTCCGAATAACGTGCAA -> GTTCCGAATAACGTGCAAA
CGTTCCGAATACTTTTACT -> GTTCCGAATACTTTTACTC
CGTTCCGAATAGGAAAACT -> GTTCCGAATAGGAAAACTC
CGTTCCGAATATCATCCAT -> GTTCCGAATATCATCCATA
CGTTGCCCAGGGATCAGCG -> GTTGCCCAGGGATCAGCGC
CGTTGCGGTTCATCCGGTG -> GTTGCGGTTCATCCGGTGG
CGTTTAATCTGGATCTACT -> GTTTAATCTGGATCTACTC
CGTTTGTACGTAGAACTGC -> GTTTGTACGTAGAACTGCT
CTAACGCGGGAAACGTCGG -> TAACGCGGGAAACGTCGGG
CTAACTCCTTGTACTAATA -> TAACTCCTTGTACTAATAT
CTAAGCACGTTAGGCCAAC -> TAAGCACGTTAGGCCAACC
CTAAGCGGCTGAATCGCAA -> TAAGCGGCTGAATCGCAAA
CTAAGTGTCCGATTGTTAT -> TAAGTGTCCGATTGTTATA
CTAATATTCAAGAAATAGG -> TAATATTCAAGAAATAGGT
CTAATATTTCGAGAGATCG -> TAATATTTCGAGAGATCGC
CTAATCTCTACCCACTTTC -> TAATCTCTACCCACTTTCA
CTAATGGTTGATGACCGTA -> TAATGGTTGATGACCGTAC
CTACAAAGACTTTAGTGGG -> TACAAAGACTTTAGTGGGT
CTACATTGATTTTCGTTGC -> TACATTGATTTTCGTTGCC
CTACCCACTTTCAGGGAGT -> TACCCACTTTCAGGGAGTA
CTACGGACTGTTACACCAT -> TACGGACTGTTACACCATC
CTACGGCCTCATTGTTGAC -> TACGGCCTCATTGTTGACA
CTACTCCCCAAGTGGAGAG -> TACTCCCCAAGTGGAGAGC
CTACTTTTCTCAACGACCA -> TACTTTTCTCAACGACCAT
CTAGCCTGGGTAAAAGGTG -> TAGCCTGGGTAAAAGGTGG
CTAGCGCAGCTCGCCAAGG -> TAGCGCAGCTCGCCAAGGT
CTAGGCGATGCTGTGATCG -> TAGGCGATGCTGTGATCGC
CTAGGCTTCGCCGAATATA -> TAGGCTTCGCCGAATATAT
CTAGGGAGTGATATCTGCC -> TAGGGAGTGATATCTGCCA
CTATAACTGATGGTGATTT -> TATAACTGATGGTGATTTT
CTATCCTTGCAATGCAAAA -> TATCCTTGCAATGCAAAAG
CTATCGCTAGGCGATGCTG -> TATCGCTAGGCGATGCTGT
CTATTGCCACAGCTCTTAC -> TATTGCCACAGCTCTTACA
CTATTGGATGCGTTTGTAC -> TATTGGATGCGTTTGTACG
CTCAACGACCATTTCGCTC -> TCAACGACCATTTCGCTCG
CTCACATGATTCTTCATCA -> TCACATGATTCTTCATCAC
CTCACATGTTGCCAGCAAC -> TCACATGTTGCCAGCAACT
CTCACCGGGTGACTATTGG -> TCACCGGGTGACTATTGGA
CTCACGCACCTCCCGGTAA -> TCACGCACCTCCCGGTAAT
CTCAGAGCGCAAAGCGCTA -> TCAGAGCGCAAAGCGCTAA
CTCAGAGGGCAGCCAACTC -> TCAGAGGGCAGCCAACTCA
CTCAGATTGCGGTGGGCGT -> TCAGATTGCGGTGGGCGTT
CTCATGAGGACTCCGTGGG -> TCATGAGGACTCCGTGGGA
CTCATTGTTGACAATTTCA -> TCATTGTTGACAATTTCAT
CTCCCACAGATCCCCGATT -> TCCCACAGATCCCCGATTC
CTCCCCAAGTGGAGAGCTA -> TCCCCAAGTGGAGAGCTAG
CTCCCGGTAATCTTTTCCT -> TCCCGGTAATCTTTTCCTA
CTCCGAGATGAGCCCTCCC -> TCCGAGATGAGCCCTCCCA
CTCCGTGGGAAACTTTGCG -> TCCGTGGGAAACTTTGCGC
CTCCTATTGCCACAGCTCT -> TCCTATTGCCACAGCTCTT
CTCCTCACGCACCTCCCGG -> TCCTCACGCACCTCCCGGT
CTCCTTGTACTAATATTCA -> TCCTTGTACTAATATTCAA
CTCGCCAAGGTCCGGAGGT -> TCGCCAAGGTCCGGAGGTT
CTCGCCTATCCTTGCAATG -> TCGCCTATCCTTGCAATGC
CTCGGACTGTTCGAGGCTA -> TCGGACTGTTCGAGGCTAA
CTCGGTCCCTGGAAACTTT -> TCGGTCCCTGGAAACTTTG
CTCGGTTTAGTTAATACTA -> TCGGTTTAGTTAATACTAG
CTCGTGCCTGGCTTCAGCA -> TCGTGCCTGGCTTCAGCAT
CTCGTGTCGAACAAAGACG -> TCGTGTCGAACAAAGACGC
CTCTACCCACTTTCAGGGA -> TCTACCCACTTTCAGGGAG
CTCTCCGAGATGAGCCCTC -> TCTCCGAGATGAGCCCTCC
CTCTTACACAGATGGTGTG -> TCTTACACAGATGGTGTGA
CTCTTACACCCACAGCTCT -> TCTTACACCCACAGCTCTT
CTCTTACACGCCACAGCTC -> TCTTACACGCCACAGCTCT
CTCTTACACTTCGGGGAAG -> TCTTACACTTCGGGGAAGT
CTCTTCACATGCGGTTTGG -> TCTTCACATGCGGTTTGGG
CTCTTGCCATTACCTTCAA -> TCTTGCCATTACCTTCAAC
CTCTTGGTTATTCGTCAGA -> TCTTGGTTATTCGTCAGAC
CTCTTTATTCGGGGAATAC -> TCTTTATTCGGGGAATACA
CTGAATCGCAAAGAGCGAA -> TGAATCGCAAAGAGCGAAG
CTGAGTCGGCAGGGACAGA -> TGAGTCGGCAGGGACAGAT
CTGATGGTGATTTTGTACG -> TGATGGTGATTTTGTACGT
CTGCAAAGTGAAGAATCTT -> TGCAAAGTGAAGAATCTTT
CTGCCAAGAATGATTTCGC -> TGCCAAGAATGATTTCGCA
CTGCGTAAGTCAGAGTTCA -> TGCGTAAGTCAGAGTTCAC
CTGCGTCCAAAAGAACCGT -> TGCGTCCAAAAGAACCGTA
CTGCTGCAAAGTGAAGAAT -> TGCTGCAAAGTGAAGAATC
CTGGAAACTTTGGTTTTTG -> TGGAAACTTTGGTTTTTGT
CTGGACTACAAAGACTTTA -> TGGACTACAAAGACTTTAG
CTGGAGATCTTCTGTATCA -> TGGAGATCTTCTGTATCAA
CTGGAGTAGGGTACCTGTC -> TGGAGTAGGGTACCTGTCT
CTGGATAGGGCTGTGGTAA -> TGGATAGGGCTGTGGTAAA
CTGGATCTACTCCCCAAGT -> TGGATCTACTCCCCAAGTG
CTGGCCCACGAGTTCGTTG -> TGGCCCACGAGTTCGTTGC
CTGGCTTCAGCATGAGGAT -> TGGCTTCAGCATGAGGATC
CTGGGTAAAAGGTGGGCGT -> TGGGTAAAAGGTGGGCGTG
CTGTAACCACCGTATAAAG -> TGTAACCACCGTATAAAGT
CTGTATCAACTTTAGGCAA -> TGTATCAACTTTAGGCAAT
CTGTCCGTTCAAAGTGATA -> TGTCCGTTCAAAGTGATAG
CTGTCTCTCCGAGATGAGC -> TGTCTCTCCGAGATGAGCC
CTGTGATCGCTTGCACACC -> TGTGATCGCTTGCACACCA
CTGTGGTAAATGCTAATGG -> TGTGGTAAATGCTAATGGT
CTGTTACACCATCGACCCA -> TGTTACACCATCGACCCAA
CTGTTCGAGGCTAACGCGG -> TGTTCGAGGCTAACGCGGG
CTTAACAGGTGAATACGTC -> TTAACAGGTGAATACGTCA
CTTACACAGATGGTGTGAC -> TTACACAGATGGTGTGACG
CTTACACCACACTGGACTA -> TTACACCACACTGGACTAC
CTTACACCCACAGCTCTTA -> TTACACCCACAGCTCTTAC
CTTACACGCCACAGCTCTT -> TTACACGCCACAGCTCTTA
CTTACACTTCGGGGAAGTT -> TTACACTTCGGGGAAGTTC
CTTACGAGTGACGTCCAGT -> TTACGAGTGACGTCCAGTC
CTTAGACACCAGATCCCTT -> TTAGACACCAGATCCCTTT
CTTAGCGCCACCGCCCTGC -> TTAGCGCCACCGCCCTGCG
CTTCAACTTAACAGGTGAA -> TTCAACTTAACAGGTGAAT
CTTCACATGCGGTTTGGGG -> TTCACATGCGGTTTGGGGT
CTTCAGACAATAAACACGG -> TTCAGACAATAAACACGGT
CTTCAGCATGAGGATCCGG -> TTCAGCATGAGGATCCGGG
CTTCATCACACGACTGGAG -> TTCATCACACGACTGGAGT
CTTCGATCCCTCTTGGTTA -> TTCGATCCCTCTTGGTTAT
CTTCGCCGAATATATCCTT -> TTCGCCGAATATATCCTTC
CTTCGGGGAAGTTCAAATT -> TTCGGGGAAGTTCAAATTG
CTTCGGTGTGTCCGGGTGT -> TTCGGTGTGTCCGGGTGTA
CTTCTGTATCAACTTTAGG -> TTCTGTATCAACTTTAGGC
CTTGAAGAGGTAGTCCTCA -> TTGAAGAGGTAGTCCTCAG
CTTGAAGGCCCGAGGTAAC -> TTGAAGGCCCGAGGTAACC
CTTGCAATGCAAAAGAGAA -> TTGCAATGCAAAAGAGAAG
CTTGCACACCATGTCGCAA -> TTGCACACCATGTCGCAAC
CTTGCCATTACCTTCAACT -> TTGCCATTACCTTCAACTT
CTTGTACTAATATTCAAGA -> TTGTACTAATATTCAAGAA
CTTGTATGATCTCGCCTAT -> TTGTATGATCTCGCCTATC
CTTTACCGCGGGAGAATTA -> TTTACCGCGGGAGAATTAT
CTTTAGGCAATGCTAAGCA -> TTTAGGCAATGCTAAGCAC
CTTTAGTGGGTTGCAGTCT -> TTTAGTGGGTTGCAGTCTA
CTTTATTCGGGGAATACAT -> TTTATTCGGGGAATACATT
CTTTCAGATTAAGCGGGTA -> TTTCAGATTAAGCGGGTAG
CTTTCAGGGAGTACTCACA -> TTTCAGGGAGTACTCACAT
CTTTGAAGGGCGGTCCGGT -> TTTGAAGGGCGGTCCGGTG
CTTTGCGCCATGACAACAG -> TTTGCGCCATGACAACAGT
CTTTGGTTTTTGTGCCGTC -> TTTGGTTTTTGTGCCGTCT
CTTTTACTCAGATTGCGGT -> TTTTACTCAGATTGCGGTG
CTTTTCCTAACTCCTTGTA -> TTTTCCTAACTCCTTGTAC
CTTTTCTCAACGACCATTT -> TTTTCTCAACGACCATTTC
GAAAACTCCTATTGCCACA -> AAAACTCCTATTGCCACAG
GAAACCGAGTCAGATTGAC -> AAACCGAGTCAGATTGACC
GAAACGTCGGGATTACCTG -> AAACGTCGGGATTACCTGG
GAAACTTTGCGCCATGACA -> AAACTTTGCGCCATGACAA
GAAACTTTGGTTTTTGTGC -> AAACTTTGGTTTTTGTGCC
GAAATAGGTTTGCAATGTT -> AAATAGGTTTGCAATGTTA
GAAATTAGAGCTGGCCCAC -> AAATTAGAGCTGGCCCACG
GAACAAAAGAGATCGGGGA -> AACAAAAGAGATCGGGGAT
GAACAAAGACGCAGTAATC -> AACAAAGACGCAGTAATCC
GAACCCTAGGGAGTGATAT -> AACCCTAGGGAGTGATATC
GAACCGTACCGGTAGACCT -> AACCGTACCGGTAGACCTC
GAACCGTACTTACACCACA -> AACCGTACTTACACCACAC
GAACTCCTCACGCACCTCC -> AACTCCTCACGCACCTCCC
GAACTGCTGCAAAGTGAAG -> AACTGCTGCAAAGTGAAGA
GAAGAACAAAAGAGATCGG -> AAGAACAAAAGAGATCGGG
GAAGAATCTTTGAAGGGCG -> AAGAATCTTTGAAGGGCGG
GAAGACGTGAACCGTACTT -> AAGACGTGAACCGTACTTA
GAAGAGGTAGTCCTCAGAG -> AAGAGGTAGTCCTCAGAGG
GAAGGATGCTATCGCTAGG -> AAGGATGCTATCGCTAGGC
GAAGGCCCGAGGTAACCTA -> AAGGCCCGAGGTAACCTAA
GAAGGGCGGTCCGGTGTCC -> AAGGGCGGTCCGGTGTCCA
GAAGTAAGTAAGTCGCCAA -> AAGTAAGTAAGTCGCCAAT
GAAGTTCAAATTGTATCAT -> AAGTTCAAATTGTATCATG
GAATAACGTGCAAAATATT -> AATAACGTGCAAAATATTG
GAATACATTCCGTAGGTCA -> AATACATTCCGTAGGTCAA
GAATACGTCACACCTCGGT -> AATACGTCACACCTCGGTT
GAATACTTTTACTCAGATT -> AATACTTTTACTCAGATTG
GAATAGGAAAACTCCTATT -> AATAGGAAAACTCCTATTG
GAATAGGTAGTTCTGCGTA -> AATAGGTAGTTCTGCGTAA
GAATATATCCTTCAGACAA -> AATATATCCTTCAGACAAT
GAATATCATCCATATAATT -> AATATCATCCATATAATTG
GAATCGCAAAGAGCGAAGA -> AATCGCAAAGAGCGAAGAC
GAATCTTTGAAGGGCGGTC -> AATCTTTGAAGGGCGGTCC
GAATGATTTCGCATTCGAA -> AATGATTTCGCATTCGAAT
GAATGGCCAACGGAAACCG -> AATGGCCAACGGAAACCGA
GAATTATCTTGAAGAGGTA -> AATTATCTTGAAGAGGTAG
GAATTCATTGCGGGACCTT -> AATTCATTGCGGGACCTTC
GAATTTATACTCACCGGGT -> AATTTATACTCACCGGGTG
GACAACAGTACTCTTGCCA -> ACAACAGTACTCTTGCCAT
GACAACATACCGGGAACCC -> ACAACATACCGGGAACCCT
GACAATAAACACGGTGGGC -> ACAATAAACACGGTGGGCG
GACAATTTCATCATCGTGG -> ACAATTTCATCATCGTGGC
GACACCAGATCCCTTTACC -> ACACCAGATCCCTTTACCG
GACACGTGCTTAGACACCA -> ACACGTGCTTAGACACCAG
GACAGATGTAGTCGCCAAG -> ACAGATGTAGTCGCCAAGA
GACCATTTCGCTCGTGCCT -> ACCATTTCGCTCGTGCCTG
GACCCAACCGCCGCCGTGA -> ACCCAACCGCCGCCGTGAT
GACCCGCCCTATAACTGAT -> ACCCGCCCTATAACTGATG
GACCGGGATGGTCTGAGTC -> ACCGGGATGGTCTGAGTCG
GACCGTACAGGCAAAGTTG -> ACCGTACAGGCAAAGTTGA
GACCTCTTTATTCGGGGAA -> ACCTCTTTATTCGGGGAAT
GACCTTCGGTGTGTCCGGG -> ACCTTCGGTGTGTCCGGGT
GACGACAACATACCGGGAA -> ACGACAACATACCGGGAAC
GACGCAGTAATCCAGGAAG -> ACGCAGTAATCCAGGAAGA
GACGGATAGCAGTATAGCG -> ACGGATAGCAGTATAGCGT
GACGTCCAGTCGATGGCAG -> ACGTCCAGTCGATGGCAGA
GACGTGAACCGTACTTACA -> ACGTGAACCGTACTTACAC
GACTACAAAGACTTTAGTG -> ACTACAAAGACTTTAGTGG
GACTACATTGATTTTCGTT -> ACTACATTGATTTTCGTTG
GACTATTGGATGCGTTTGT -> ACTATTGGATGCGTTTGTA
GACTCCGTGGGAAACTTTG -> ACTCCGTGGGAAACTTTGC
GACTGGAGTAGGGTACCTG -> ACTGGAGTAGGGTACCTGT
GACTGTTACACCATCGACC -> ACTGTTACACCATCGACCC
GACTGTTCGAGGCTAACGC -> ACTGTTCGAGGCTAACGCG
GACTTAGCGCCACCGCCCT -> ACTTAGCGCCACCGCCCTG
GACTTGTATGATCTCGCCT -> ACTTGTATGATCTCGCCTA
GACTTTAGTGGGTTGCAGT -> ACTTTAGTGGGTTGCAGTC
GACTTTCAGATTAAGCGGG -> ACTTTCAGATTAAGCGGGT
GAGAAGTAAGTAAGTCGCC -> AGAAGTAAGTAAGTCGCCA
GAGAATAGGTAGTTCTGCG -> AGAATAGGTAGTTCTGCGT
GAGAATTATCTTGAAGAGG -> AGAATTATCTTGAAGAGGT
GAGACTTAGCGCCACCGCC -> AGACTTAGCGCCACCGCCC
GAGAGATCGCGCTAGCGCA -> AGAGATCGCGCTAGCGCAG
GAGAGCTAGGCTTCGCCGA -> AGAGCTAGGCTTCGCCGAA
GAGAGTAATAGTGACCGGG -> AGAGTAATAGTGACCGGGA
GAGATCGCGCTAGCGCAGC -> AGATCGCGCTAGCGCAGCT
GAGATCGGGGATTATGTGC -> AGATCGGGGATTATGTGCT
GAGATCTTCTGTATCAACT -> AGATCTTCTGTATCAACTT
GAGATGAGCCCTCCCACAG -> AGATGAGCCCTCCCACAGA
GAGCCCTCCCACAGATCCC -> AGCCCTCCCACAGATCCCC
GAGCCTCGTGTCGAACAAA -> AGCCTCGTGTCGAACAAAG
GAGCGAAGACGTGAACCGT -> AGCGAAGACGTGAACCGTA
GAGCGCAAAGCGCTAAGCG -> AGCGCAAAGCGCTAAGCGG
GAGCTAGGCTTCGCCGAAT -> AGCTAGGCTTCGCCGAATA
GAGCTGGCCCACGAGTTCG -> AGCTGGCCCACGAGTTCGT
GAGGACTCCGTGGGAAACT -> AGGACTCCGTGGGAAACTT
GAGGATCCGGGAGAGTAAT -> AGGATCCGGGAGAGTAATA
GAGGCTAACGCGGGAAACG -> AGGCTAACGCGGGAAACGT
GAGGGCAGCCAACTCATGA -> AGGGCAGCCAACTCATGAG
GAGGTAACCTAATATTTCG -> AGGTAACCTAATATTTCGA
GAGGTAGTCCTCAGAGGGC -> AGGTAGTCCTCAGAGGGCA
GAGGTTTAAAAGGACTTTC -> AGGTTTAAAAGGACTTTCA
GAGTAATAGTGACCGGGAT -> AGTAATAGTGACCGGGATG
GAGTACTCACATGATTCTT -> AGTACTCACATGATTCTTC
GAGTAGGGTACCTGTCTCT -> AGTAGGGTACCTGTCTCTC
GAGTCAGATTGACCCGCCC -> AGTCAGATTGACCCGCCCT
GAGTCGGCAGGGACAGATG -> AGTCGGCAGGGACAGATGT
GAGTGACGTCCAGTCGATG -> AGTGACGTCCAGTCGATGG
GAGTGATATCTGCCAAGAA -> AGTGATATCTGCCAAGAAT
GAGTTCACTTGAAGGCCCG -> AGTTCACTTGAAGGCCCGA
GAGTTCGTTGCGGTTCATC -> AGTTCGTTGCGGTTCATCC
GAGTTGCCCAAAGGCCTAA -> AGTTGCCCAAAGGCCTAAT
GAGTTGGCGCCAACAATGC -> AGTTGGCGCCAACAATGCC
GATAGCAGTATAGCGTTAG -> ATAGCAGTATAGCGTTAGT
GATAGGGCTGTGGTAAATG -> ATAGGGCTGTGGTAAATGC
GATAGTCACTCGGACTGTT -> ATAGTCACTCGGACTGTTC
GATATCTGCCAAGAATGAT -> ATATCTGCCAAGAATGATT
GATCAGCGCCGCTCACATG -> ATCAGCGCCGCTCACATGT
GATCCCCGATTCAATCTCG -> ATCCCCGATTCAATCTCGG
GATCCCTCTTGGTTATTCG -> ATCCCTCTTGGTTATTCGT
GATCCCTTTACCGCGGGAG -> ATCCCTTTACCGCGGGAGA
GATCCGGGAGAGTAATAGT -> ATCCGGGAGAGTAATAGTG
GATCCTGTAACCACCGTAT -> ATCCTGTAACCACCGTATA
GATCGACTACATTGATTTT -> ATCGACTACATTGATTTTC
GATCGCGCTAGCGCAGCTC -> ATCGCGCTAGCGCAGCTCG
GATCGCTTGCACACCATGT -> ATCGCTTGCACACCATGTC
GATCGGGGATTATGTGCTA -> ATCGGGGATTATGTGCTAC
GATCTACTCCCCAAGTGGA -> ATCTACTCCCCAAGTGGAG
GATCTCGCCTATCCTTGCA -> ATCTCGCCTATCCTTGCAA
GATCTTCTGTATCAACTTT -> ATCTTCTGTATCAACTTTA
GATGACCGTACAGGCAAAG -> ATGACCGTACAGGCAAAGT
GATGACGACAACATACCGG -> ATGACGACAACATACCGGG
GATGAGAATAGGTAGTTCT -> ATGAGAATAGGTAGTTCTG
GATGAGCCCTCCCACAGAT -> ATGAGCCCTCCCACAGATC
GATGCGTTTGTACGTAGAA -> ATGCGTTTGTACGTAGAAC
GATGCTATCGCTAGGCGAT -> ATGCTATCGCTAGGCGATG
GATGCTGTGATCGCTTGCA -> ATGCTGTGATCGCTTGCAC
GATGGCAGATTGATGAGAA -> ATGGCAGATTGATGAGAAT
GATGGTCTGAGTCGGCAGG -> ATGGTCTGAGTCGGCAGGG
GATGGTGATTTTGTACGTC -> ATGGTGATTTTGTACGTCG
GATGGTGTGACGGATAGCA -> ATGGTGTGACGGATAGCAG
GATGTAGTCGCCAAGACAC -> ATGTAGTCGCCAAGACACG
GATTAAGCGGGTAGGTGAT -> ATTAAGCGGGTAGGTGATC
GATTACCTGGAGATCTTCT -> ATTACCTGGAGATCTTCTG
GATTATGTGCTACTTTTCT -> ATTATGTGCTACTTTTCTC
GATTCAATCTCGGTCCCTG -> ATTCAATCTCGGTCCCTGG
GATTCTTCATCACACGACT -> ATTCTTCATCACACGACTG
GATTGACCCGCCCTATAAC -> ATTGACCCGCCCTATAACT
GATTGATGAGAATAGGTAG -> ATTGATGAGAATAGGTAGT
GATTGCGGTGGGCGTTCCG -> ATTGCGGTGGGCGTTCCGA
GATTGTTATACGAGCCTCG -> ATTGTTATACGAGCCTCGT
GATTTCGCATTCGAATGGC -> ATTTCGCATTCGAATGGCC
GATTTTCGTTGCCCAGGGA -> ATTTTCGTTGCCCAGGGAT
GATTTTGTACGTCGGTACG -> ATTTTGTACGTCGGTACGT
GCAAAAGAGAAGTAAGTAA -> CAAAAGAGAAGTAAGTAAG
GCAAAATATTGTCGGTGGG -> CAAAATATTGTCGGTGGGC
GCAAAGAGCGAAGACGTGA -> CAAAGAGCGAAGACGTGAA
GCAAAGCGCTAAGCGGCTG -> CAAAGCGCTAAGCGGCTGA
GCAAAGTGAAGAATCTTTG -> CAAAGTGAAGAATCTTTGA
GCAAAGTTGAATTCATTGC -> CAAAGTTGAATTCATTGCG
GCAACAAGTGTCCGCGAGT -> CAACAAGTGTCCGCGAGTT
GCAACGCTCAGAGCGCAAA -> CAACGCTCAGAGCGCAAAG
GCAACTACGGCCTCATTGT -> CAACTACGGCCTCATTGTT
GCAAGACTTGTATGATCTC -> CAAGACTTGTATGATCTCG
GCAATGCAAAAGAGAAGTA -> CAATGCAAAAGAGAAGTAA
GCAATGCTAAGCACGTTAG -> CAATGCTAAGCACGTTAGG
GCAATGTTACGGGTACAGA -> CAATGTTACGGGTACAGAA
GCACACCATGTCGCAACGC -> CACACCATGTCGCAACGCT
GCACCTCCCGGTAATCTTT -> CACCTCCCGGTAATCTTTT
GCACGTGGGTTCATTCCCC -> CACGTGGGTTCATTCCCCA
GCACGTTAGGCCAACCGTT -> CACGTTAGGCCAACCGTTT
GCAGATTGATGAGAATAGG -> CAGATTGATGAGAATAGGT
GCAGCCAACTCATGAGGAC -> CAGCCAACTCATGAGGACT
GCAGCTCGCCAAGGTCCGG -> CAGCTCGCCAAGGTCCGGA
GCAGGGACAGATGTAGTCG -> CAGGGACAGATGTAGTCGC
GCAGTAATCCAGGAAGAAC -> CAGTAATCCAGGAAGAACA
GCAGTATAGCGTTAGTTGG -> CAGTATAGCGTTAGTTGGG
GCAGTCTAAGTGTCCGATT -> CAGTCTAAGTGTCCGATTG
GCATGAGGATCCGGGAGAG -> CATGAGGATCCGGGAGAGT
GCATTCGAATGGCCAACGG -> CATTCGAATGGCCAACGGA
GCCAACAATGCCTGTCCGT -> CCAACAATGCCTGTCCGTT
GCCAACCGTTTAATCTGGA -> CCAACCGTTTAATCTGGAT
GCCAACGGAAACCGAGTCA -> CCAACGGAAACCGAGTCAG
GCCAACTCATGAGGACTCC -> CCAACTCATGAGGACTCCG
GCCAAGAATGATTTCGCAT -> CCAAGAATGATTTCGCATT
GCCAAGACACGTGCTTAGA -> CCAAGACACGTGCTTAGAC
GCCAAGGTCCGGAGGTTTA -> CCAAGGTCCGGAGGTTTAA
GCCAATGCCTACGGACTGT -> CCAATGCCTACGGACTGTT
GCCACAGCTCTTACACCCA -> CCACAGCTCTTACACCCAC
GCCACAGCTCTTACACGCC -> CCACAGCTCTTACACGCCA
GCCACAGCTCTTACACTTC -> CCACAGCTCTTACACTTCG
GCCACCGCCCTGCGTCCAA -> CCACCGCCCTGCGTCCAAA
GCCAGCAACTACGGCCTCA -> CCAGCAACTACGGCCTCAT
GCCATGACAACAGTACTCT -> CCATGACAACAGTACTCTT
GCCATTACCTTCAACTTAA -> CCATTACCTTCAACTTAAC
GCCCAAAGGCCTAATCTCT -> CCCAAAGGCCTAATCTCTA
GCCCACGAGTTCGTTGCGG -> CCCACGAGTTCGTTGCGGT
GCCCAGGGATCAGCGCCGC -> CCCAGGGATCAGCGCCGCT
GCCCGAGGTAACCTAATAT -> CCCGAGGTAACCTAATATT
GCCCTATAACTGATGGTGA -> CCCTATAACTGATGGTGAT
GCCCTCCCACAGATCCCCG -> CCCTCCCACAGATCCCCGA
GCCCTGCGTCCAAAAGAAC -> CCCTGCGTCCAAAAGAACC
GCCGAATATATCCTTCAGA -> CCGAATATATCCTTCAGAC
GCCGCCGTGATCGACTACA -> CCGCCGTGATCGACTACAT
GCCGCGCAACAAGTGTCCG -> CCGCGCAACAAGTGTCCGC
GCCGCTCACATGTTGCCAG -> CCGCTCACATGTTGCCAGC
GCCGGGAGTTGCCCAAAGG -> CCGGGAGTTGCCCAAAGGC
GCCGTCTGGATAGGGCTGT -> CCGTCTGGATAGGGCTGTG
GCCGTGATCGACTACATTG -> CCGTGATCGACTACATTGA
GCCTAATCTCTACCCACTT -> CCTAATCTCTACCCACTTT
GCCTACGGACTGTTACACC -> CCTACGGACTGTTACACCA
GCCTATCCTTGCAATGCAA -> CCTATCCTTGCAATGCAAA
GCCTCATTGTTGACAATTT -> CCTCATTGTTGACAATTTC
GCCTCGTGTCGAACAAAGA -> CCTCGTGTCGAACAAAGAC
GCCTGGCTTCAGCATGAGG -> CCTGGCTTCAGCATGAGGA
GCCTGGGTAAAAGGTGGGC -> CCTGGGTAAAAGGTGGGCG
GCCTGTCCGTTCAAAGTGA -> CCTGTCCGTTCAAAGTGAT
GCGAACTCCTCACGCACCT -> CGAACTCCTCACGCACCTC
GCGAAGACGTGAACCGTAC -> CGAAGACGTGAACCGTACT
GCGAGTTGGCGCCAACAAT -> CGAGTTGGCGCCAACAATG
GCGATGCTGTGATCGCTTG -> CGATGCTGTGATCGCTTGC
GCGCAAAGCGCTAAGCGGC -> CGCAAAGCGCTAAGCGGCT
GCGCAACAAGTGTCCGCGA -> CGCAACAAGTGTCCGCGAG
GCGCAGCTCGCCAAGGTCC -> CGCAGCTCGCCAAGGTCCG
GCGCCAACAATGCCTGTCC -> CGCCAACAATGCCTGTCCG
GCGCCACCGCCCTGCGTCC -> CGCCACCGCCCTGCGTCCA
GCGCCATGACAACAGTACT -> CGCCATGACAACAGTACTC
GCGCCGCGCAACAAGTGTC -> CGCCGCGCAACAAGTGTCC
GCGCCGCTCACATGTTGCC -> CGCCGCTCACATGTTGCCA
GCGCTAAGCGGCTGAATCG -> CGCTAAGCGGCTGAATCGC
GCGCTAGCGCAGCTCGCCA -> CGCTAGCGCAGCTCGCCAA
GCGGCTGAATCGCAAAGAG -> CGGCTGAATCGCAAAGAGC
GCGGGAAACGTCGGGATTA -> CGGGAAACGTCGGGATTAC
GCGGGACCTTCGGTGTGTC -> CGGGACCTTCGGTGTGTCC
GCGGGAGAATTATCTTGAA -> CGGGAGAATTATCTTGAAG
GCGGGTAGGTGATCCTGTA -> CGGGTAGGTGATCCTGTAA
GCGGTCCGGTGTCCACAAT -> CGGTCCGGTGTCCACAATC
GCGGTGGGCGTTCCGAATA -> CGGTGGGCGTTCCGAATAG
GCGGTTCATCCGGTGGGCG -> CGGTTCATCCGGTGGGCGT
GCGGTTTGGGGTAGGCACG -> CGGTTTGGGGTAGGCACGT
GCGTAAGTCAGAGTTCACT -> CGTAAGTCAGAGTTCACTT
GCGTAGCGCCGCGCAACAA -> CGTAGCGCCGCGCAACAAG
GCGTCCAAAAGAACCGTAC -> CGTCCAAAAGAACCGTACC
GCGTGTCTTCGATCCCTCT -> CGTGTCTTCGATCCCTCTT
GCGTTAGTTGGGCTTACGA -> CGTTAGTTGGGCTTACGAG
GCGTTCCGAATAACGTGCA -> CGTTCCGAATAACGTGCAA
GCGTTCCGAATACTTTTAC -> CGTTCCGAATACTTTTACT
GCGTTCCGAATAGGAAAAC -> CGTTCCGAATAGGAAAACT
GCGTTCCGAATATCATCCA -> CGTTCCGAATATCATCCAT
GCGTTTGTACGTAGAACTG -> CGTTTGTACGTAGAACTGC
GCTAACGCGGGAAACGTCG -> CTAACGCGGGAAACGTCGG
GCTAAGCACGTTAGGCCAA -> CTAAGCACGTTAGGCCAAC
GCTAAGCGGCTGAATCGCA -> CTAAGCGGCTGAATCGCAA
GCTAATGGTTGATGACCGT -> CTAATGGTTGATGACCGTA
GCTACTTTTCTCAACGACC -> CTACTTTTCTCAACGACCA
GCTAGCGCAGCTCGCCAAG -> CTAGCGCAGCTCGCCAAGG
GCTAGGCGATGCTGTGATC -> CTAGGCGATGCTGTGATCG
GCTAGGCTTCGCCGAATAT -> CTAGGCTTCGCCGAATATA
GCTATCGCTAGGCGATGCT -> CTATCGCTAGGCGATGCTG
GCTCACATGTTGCCAGCAA -> CTCACATGTTGCCAGCAAC
GCTCAGAGCGCAAAGCGCT -> CTCAGAGCGCAAAGCGCTA
GCTCGCCAAGGTCCGGAGG -> CTCGCCAAGGTCCGGAGGT
GCTCGTGCCTGGCTTCAGC -> CTCGTGCCTGGCTTCAGCA
GCTCTTACACAGATGGTGT -> CTCTTACACAGATGGTGTG
GCTCTTACACCCACAGCTC -> CTCTTACACCCACAGCTCT
GCTCTTACACGCCACAGCT -> CTCTTACACGCCACAGCTC
GCTCTTACACTTCGGGGAA -> CTCTTACACTTCGGGGAAG
GCTGAATCGCAAAGAGCGA -> CTGAATCGCAAAGAGCGAA
GCTGCAAAGTGAAGAATCT -> CTGCAAAGTGAAGAATCTT
GCTGGCCCACGAGTTCGTT -> CTGGCCCACGAGTTCGTTG
GCTGTGATCGCTTGCACAC -> CTGTGATCGCTTGCACACC
GCTGTGGTAAATGCTAATG -> CTGTGGTAAATGCTAATGG
GCTTACGAGTGACGTCCAG -> CTTACGAGTGACGTCCAGT
GCTTAGACACCAGATCCCT -> CTTAGACACCAGATCCCTT
GCTTCAGCATGAGGATCCG -> CTTCAGCATGAGGATCCGG
GCTTCGCCGAATATATCCT -> CTTCGCCGAATATATCCTT
GCTTGCACACCATGTCGCA -> CTTGCACACCATGTCGCAA
GGAAAACTCCTATTGCCAC -> GAAAACTCCTATTGCCACA
GGAAACCGAGTCAGATTGA -> GAAACCGAGTCAGATTGAC
GGAAACGTCGGGATTACCT -> GAAACGTCGGGATTACCTG
GGAAACTTTGCGCCATGAC -> GAAACTTTGCGCCATGACA
GGAAACTTTGGTTTTTGTG -> GAAACTTTGGTTTTTGTGC
GGAACCCTAGGGAGTGATA -> GAACCCTAGGGAGTGATAT
GGAAGAACAAAAGAGATCG -> GAAGAACAAAAGAGATCGG
GGAAGTTCAAATTGTATCA -> GAAGTTCAAATTGTATCAT
GGAATACATTCCGTAGGTC -> GAATACATTCCGTAGGTCA
GGACAGATGTAGTCGCCAA -> GACAGATGTAGTCGCCAAG
GGACCTTCGGTGTGTCCGG -> GACCTTCGGTGTGTCCGGG
GGACTACAAAGACTTTAGT -> GACTACAAAGACTTTAGTG
GGACTCCGTGGGAAACTTT -> GACTCCGTGGGAAACTTTG
GGACTGTTACACCATCGAC -> GACTGTTACACCATCGACC
GGACTGTTCGAGGCTAACG -> GACTGTTCGAGGCTAACGC
GGACTTTCAGATTAAGCGG -> GACTTTCAGATTAAGCGGG
GGAGAATTATCTTGAAGAG -> GAGAATTATCTTGAAGAGG
GGAGAGCTAGGCTTCGCCG -> GAGAGCTAGGCTTCGCCGA
GGAGAGTAATAGTGACCGG -> GAGAGTAATAGTGACCGGG
GGAGATCTTCTGTATCAAC -> GAGATCTTCTGTATCAACT
GGAGGTTTAAAAGGACTTT -> GAGGTTTAAAAGGACTTTC
GGAGTACTCACATGATTCT -> GAGTACTCACATGATTCTT
GGAGTAGGGTACCTGTCTC -> GAGTAGGGTACCTGTCTCT
GGAGTGATATCTGCCAAGA -> GAGTGATATCTGCCAAGAA
GGAGTTGCCCAAAGGCCTA -> GAGTTGCCCAAAGGCCTAA
GGATAGCAGTATAGCGTTA -> GATAGCAGTATAGCGTTAG
GGATAGGGCTGTGGTAAAT -> GATAGGGCTGTGGTAAATG
GGATCAGCGCCGCTCACAT -> GATCAGCGCCGCTCACATG
GGATCCGGGAGAGTAATAG -> GATCCGGGAGAGTAATAGT
GGATCTACTCCCCAAGTGG -> GATCTACTCCCCAAGTGGA
GGATGCGTTTGTACGTAGA -> GATGCGTTTGTACGTAGAA
GGATGCTATCGCTAGGCGA -> GATGCTATCGCTAGGCGAT
GGATGGTCTGAGTCGGCAG -> GATGGTCTGAGTCGGCAGG
GGATTACCTGGAGATCTTC -> GATTACCTGGAGATCTTCT
GGATTATGTGCTACTTTTC -> GATTATGTGCTACTTTTCT
GGCAAAGTTGAATTCATTG -> GCAAAGTTGAATTCATTGC
GGCAATGCTAAGCACGTTA -> GCAATGCTAAGCACGTTAG
GGCACGTGGGTTCATTCCC -> GCACGTGGGTTCATTCCCC
GGCAGATTGATGAGAATAG -> GCAGATTGATGAGAATAGG
GGCAGCCAACTCATGAGGA -> GCAGCCAACTCATGAGGAC
GGCAGGGACAGATGTAGTC -> GCAGGGACAGATGTAGTCG
GGCCAACCGTTTAATCTGG -> GCCAACCGTTTAATCTGGA
GGCCAACGGAAACCGAGTC -> GCCAACGGAAACCGAGTCA
GGCCCACGAGTTCGTTGCG -> GCCCACGAGTTCGTTGCGG
GGCCCGAGGTAACCTAATA -> GCCCGAGGTAACCTAATAT
GGCCTAATCTCTACCCACT -> GCCTAATCTCTACCCACTT
GGCCTCATTGTTGACAATT -> GCCTCATTGTTGACAATTT
GGCGATGCTGTGATCGCTT -> GCGATGCTGTGATCGCTTG
GGCGCCAACAATGCCTGTC -> GCGCCAACAATGCCTGTCC
GGCGGTCCGGTGTCCACAA -> GCGGTCCGGTGTCCACAAT
GGCGTAGCGCCGCGCAACA -> GCGTAGCGCCGCGCAACAA
GGCGTGTCTTCGATCCCTC -> GCGTGTCTTCGATCCCTCT
GGCGTTCCGAATAACGTGC -> GCGTTCCGAATAACGTGCA
GGCGTTCCGAATACTTTTA -> GCGTTCCGAATACTTTTAC
GGCGTTCCGAATAGGAAAA -> GCGTTCCGAATAGGAAAAC
GGCGTTCCGAATATCATCC -> GCGTTCCGAATATCATCCA
GGCTAACGCGGGAAACGTC -> GCTAACGCGGGAAACGTCG
GGCTGAATCGCAAAGAGCG -> GCTGAATCGCAAAGAGCGA
GGCTGTGGTAAATGCTAAT -> GCTGTGGTAAATGCTAATG
GGCTTACGAGTGACGTCCA -> GCTTACGAGTGACGTCCAG
GGCTTCAGCATGAGGATCC -> GCTTCAGCATGAGGATCCG
GGCTTCGCCGAATATATCC -> GCTTCGCCGAATATATCCT
GGGAAACGTCGGGATTACC -> GGAAACGTCGGGATTACCT
GGGAAACTTTGCGCCATGA -> GGAAACTTTGCGCCATGAC
GGGAACCCTAGGGAGTGAT -> GGAACCCTAGGGAGTGATA
GGGAAGTTCAAATTGTATC -> GGAAGTTCAAATTGTATCA
GGGAATACATTCCGTAGGT -> GGAATACATTCCGTAGGTC
GGGACAGATGTAGTCGCCA -> GGACAGATGTAGTCGCCAA
GGGACCTTCGGTGTGTCCG -> GGACCTTCGGTGTGTCCGG
GGGAGAATTATCTTGAAGA -> GGAGAATTATCTTGAAGAG
GGGAGAGTAATAGTGACCG -> GGAGAGTAATAGTGACCGG
GGGAGTACTCACATGATTC -> GGAGTACTCACATGATTCT
GGGAGTGATATCTGCCAAG -> GGAGTGATATCTGCCAAGA
GGGAGTTGCCCAAAGGCCT -> GGAGTTGCCCAAAGGCCTA
GGGATCAGCGCCGCTCACA -> GGATCAGCGCCGCTCACAT
GGGATGGTCTGAGTCGGCA -> GGATGGTCTGAGTCGGCAG
GGGATTACCTGGAGATCTT -> GGATTACCTGGAGATCTTC
GGGATTATGTGCTACTTTT -> GGATTATGTGCTACTTTTC
GGGCAGCCAACTCATGAGG -> GGCAGCCAACTCATGAGGA
GGGCGGTCCGGTGTCCACA -> GGCGGTCCGGTGTCCACAA
GGGCGTGTCTTCGATCCCT -> GGCGTGTCTTCGATCCCTC
GGGCGTTCCGAATAACGTG -> GGCGTTCCGAATAACGTGC
GGGCGTTCCGAATACTTTT -> GGCGTTCCGAATACTTTTA
GGGCGTTCCGAATAGGAAA -> GGCGTTCCGAATAGGAAAA
GGGCGTTCCGAATATCATC -> GGCGTTCCGAATATCATCC
GGGCTGTGGTAAATGCTAA -> GGCTGTGGTAAATGCTAAT
GGGCTTACGAGTGACGTCC -> GGCTTACGAGTGACGTCCA
GGGGAAGTTCAAATTGTAT -> GGGAAGTTCAAATTGTATC
GGGGAATACATTCCGTAGG -> GGGAATACATTCCGTAGGT
GGGGATTATGTGCTACTTT -> GGGATTATGTGCTACTTTT
GGGGTAGGCACGTGGGTTC -> GGGTAGGCACGTGGGTTCA
GGGTAAAAGGTGGGCGTGT -> GGTAAAAGGTGGGCGTGTC
GGGTACAGAAGGATGCTAT -> GGTACAGAAGGATGCTATC
GGGTACCTGTCTCTCCGAG -> GGTACCTGTCTCTCCGAGA
GGGTAGGCACGTGGGTTCA -> GGTAGGCACGTGGGTTCAT
GGGTAGGTGATCCTGTAAC -> GGTAGGTGATCCTGTAACC
GGGTGACTATTGGATGCGT -> GGTGACTATTGGATGCGTT
GGGTGTATGCAAGACTTGT -> GGTGTATGCAAGACTTGTA
GGGTTCATTCCCCATGAAT -> GGTTCATTCCCCATGAATT
GGGTTGCAGTCTAAGTGTC -> GGTTGCAGTCTAAGTGTCC
GGTAAAAGGTGGGCGTGTC -> GTAAAAGGTGGGCGTGTCT
GGTAAATGCTAATGGTTGA -> GTAAATGCTAATGGTTGAT
GGTAACCTAATATTTCGAG -> GTAACCTAATATTTCGAGA
GGTAATCTTTTCCTAACTC -> GTAATCTTTTCCTAACTCC
GGTACAGAAGGATGCTATC -> GTACAGAAGGATGCTATCG
GGTACCTGTCTCTCCGAGA -> GTACCTGTCTCTCCGAGAT
GGTACGTAATCAAGCGAAC -> GTACGTAATCAAGCGAACT
GGTAGACCTCTTTATTCGG -> GTAGACCTCTTTATTCGGG
GGTAGGCACGTGGGTTCAT -> GTAGGCACGTGGGTTCATT
GGTAGGTGATCCTGTAACC -> GTAGGTGATCCTGTAACCA
GGTAGTCCTCAGAGGGCAG -> GTAGTCCTCAGAGGGCAGC
GGTAGTTCTGCGTAAGTCA -> GTAGTTCTGCGTAAGTCAG
GGTCAATTATTGATGACGA -> GTCAATTATTGATGACGAC
GGTCCCTGGAAACTTTGGT -> GTCCCTGGAAACTTTGGTT
GGTCCGGAGGTTTAAAAGG -> GTCCGGAGGTTTAAAAGGA
GGTCCGGTGTCCACAATCA -> GTCCGGTGTCCACAATCAA
GGTCTGAGTCGGCAGGGAC -> GTCTGAGTCGGCAGGGACA
GGTGAATACGTCACACCTC -> GTGAATACGTCACACCTCG
GGTGACTATTGGATGCGTT -> GTGACTATTGGATGCGTTT
GGTGATCCTGTAACCACCG -> GTGATCCTGTAACCACCGT
GGTGATTTTGTACGTCGGT -> GTGATTTTGTACGTCGGTA
GGTGGGCGTGTCTTCGATC -> GTGGGCGTGTCTTCGATCC
GGTGGGCGTTCCGAATAAC -> GTGGGCGTTCCGAATAACG
GGTGGGCGTTCCGAATACT -> GTGGGCGTTCCGAATACTT
GGTGGGCGTTCCGAATAGG -> GTGGGCGTTCCGAATAGGA
GGTGGGCGTTCCGAATATC -> GTGGGCGTTCCGAATATCA
GGTGTATGCAAGACTTGTA -> GTGTATGCAAGACTTGTAT
GGTGTCCACAATCAATTGA -> GTGTCCACAATCAATTGAA
GGTGTGACGGATAGCAGTA -> GTGTGACGGATAGCAGTAT
GGTGTGTCCGGGTGTATGC -> GTGTGTCCGGGTGTATGCA
GGTTCATCCGGTGGGCGTT -> GTTCATCCGGTGGGCGTTC
GGTTCATTCCCCATGAATT -> GTTCATTCCCCATGAATTT
GGTTGATGACCGTACAGGC -> GTTGATGACCGTACAGGCA
GGTTGCAGTCTAAGTGTCC -> GTTGCAGTCTAAGTGTCCG
GGTTTAAAAGGACTTTCAG -> GTTTAAAAGGACTTTCAGA
GGTTTAGTTAATACTAGCC -> GTTTAGTTAATACTAGCCT
GGTTTGCAATGTTACGGGT -> GTTTGCAATGTTACGGGTA
GGTTTGGGGTAGGCACGTG -> GTTTGGGGTAGGCACGTGG
GGTTTTTGTGCCGTCTGGA -> GTTTTTGTGCCGTCTGGAT
GTAAAAGGTGGGCGTGTCT -> TAAAAGGTGGGCGTGTCTT
GTAAATGCTAATGGTTGAT -> TAAATGCTAATGGTTGATG
GTAACCACCGTATAAAGTA -> TAACCACCGTATAAAGTAA
GTAACCTAATATTTCGAGA -> TAACCTAATATTTCGAGAG
GTAAGAGACTTAGCGCCAC -> TAAGAGACTTAGCGCCACC
GTAAGTAAGAGACTTAGCG -> TAAGTAAGAGACTTAGCGC
GTAAGTAAGTCGCCAATGC -> TAAGTAAGTCGCCAATGCC
GTAAGTCAGAGTTCACTTG -> TAAGTCAGAGTTCACTTGA
GTAAGTCGCCAATGCCTAC -> TAAGTCGCCAATGCCTACG
GTAATAGTGACCGGGATGG -> TAATAGTGACCGGGATGGT
GTAATCAAGCGAACTCCTC -> TAATCAAGCGAACTCCTCA
GTAATCCAGGAAGAACAAA -> TAATCCAGGAAGAACAAAA
GTAATCTTTTCCTAACTCC -> TAATCTTTTCCTAACTCCT
GTACAGAAGGATGCTATCG -> TACAGAAGGATGCTATCGC
GTACAGGCAAAGTTGAATT -> TACAGGCAAAGTTGAATTC
GTACCGGTAGACCTCTTTA -> TACCGGTAGACCTCTTTAT
GTACCTGTCTCTCCGAGAT -> TACCTGTCTCTCCGAGATG
GTACGTAATCAAGCGAACT -> TACGTAATCAAGCGAACTC
GTACGTAGAACTGCTGCAA -> TACGTAGAACTGCTGCAAA
GTACGTCGGTACGTAATCA -> TACGTCGGTACGTAATCAA
GTACTAATATTCAAGAAAT -> TACTAATATTCAAGAAATA
GTACTCACATGATTCTTCA -> TACTCACATGATTCTTCAT
GTACTCTTGCCATTACCTT -> TACTCTTGCCATTACCTTC
GTACTTACACCACACTGGA -> TACTTACACCACACTGGAC
GTAGAACTGCTGCAAAGTG -> TAGAACTGCTGCAAAGTGA
GTAGACCTCTTTATTCGGG -> TAGACCTCTTTATTCGGGG
GTAGCGCCGCGCAACAAGT -> TAGCGCCGCGCAACAAGTG
GTAGGCACGTGGGTTCATT -> TAGGCACGTGGGTTCATTC
GTAGGGTACCTGTCTCTCC -> TAGGGTACCTGTCTCTCCG
GTAGGTCAATTATTGATGA -> TAGGTCAATTATTGATGAC
GTAGGTGATCCTGTAACCA -> TAGGTGATCCTGTAACCAC
GTAGTCCTCAGAGGGCAGC -> TAGTCCTCAGAGGGCAGCC
GTAGTCGCCAAGACACGTG -> TAGTCGCCAAGACACGTGC
GTAGTTCTGCGTAAGTCAG -> TAGTTCTGCGTAAGTCAGA
GTATAAAGTAAGTAAGAGA -> TATAAAGTAAGTAAGAGAC
GTATAGCGTTAGTTGGGCT -> TATAGCGTTAGTTGGGCTT
GTATCAACTTTAGGCAATG -> TATCAACTTTAGGCAATGC
GTATCATGCCGGGAGTTGC -> TATCATGCCGGGAGTTGCC
GTATGATCTCGCCTATCCT -> TATGATCTCGCCTATCCTT
GTATGCAAGACTTGTATGA -> TATGCAAGACTTGTATGAT
GTCAATTATTGATGACGAC -> TCAATTATTGATGACGACA
GTCACACCTCGGTTTAGTT -> TCACACCTCGGTTTAGTTA
GTCACTCGGACTGTTCGAG -> TCACTCGGACTGTTCGAGG
GTCAGAGTTCACTTGAAGG -> TCAGAGTTCACTTGAAGGC
GTCAGATTGACCCGCCCTA -> TCAGATTGACCCGCCCTAT
GTCCAAAAGAACCGTACCG -> TCCAAAAGAACCGTACCGG
GTCCACAATCAATTGAAAT -> TCCACAATCAATTGAAATT
GTCCAGTCGATGGCAGATT -> TCCAGTCGATGGCAGATTG
GTCCCTGGAAACTTTGGTT -> TCCCTGGAAACTTTGGTTT
GTCCGATTGTTATACGAGC -> TCCGATTGTTATACGAGCC
GTCCGCGAGTTGGCGCCAA -> TCCGCGAGTTGGCGCCAAC
GTCCGGAGGTTTAAAAGGA -> TCCGGAGGTTTAAAAGGAC
GTCCGGGTGTATGCAAGAC -> TCCGGGTGTATGCAAGACT
GTCCGGTGTCCACAATCAA -> TCCGGTGTCCACAATCAAT
GTCCGTTCAAAGTGATAGT -> TCCGTTCAAAGTGATAGTC
GTCCTCAGAGGGCAGCCAA -> TCCTCAGAGGGCAGCCAAC
GTCGAACAAAGACGCAGTA -> TCGAACAAAGACGCAGTAA
GTCGATGGCAGATTGATGA -> TCGATGGCAGATTGATGAG
GTCGCAACGCTCAGAGCGC -> TCGCAACGCTCAGAGCGCA
GTCGCCAAGACACGTGCTT -> TCGCCAAGACACGTGCTTA
GTCGCCAATGCCTACGGAC -> TCGCCAATGCCTACGGACT
GTCGGCAGGGACAGATGTA -> TCGGCAGGGACAGATGTAG
GTCGGGATTACCTGGAGAT -> TCGGGATTACCTGGAGATC
GTCGGTACGTAATCAAGCG -> TCGGTACGTAATCAAGCGA
GTCGGTGGGCGTTCCGAAT -> TCGGTGGGCGTTCCGAATA
GTCTAAGTGTCCGATTGTT -> TCTAAGTGTCCGATTGTTA
GTCTCTCCGAGATGAGCCC -> TCTCTCCGAGATGAGCCCT
GTCTGAGTCGGCAGGGACA -> TCTGAGTCGGCAGGGACAG
GTCTGGATAGGGCTGTGGT -> TCTGGATAGGGCTGTGGTA
GTCTTCGATCCCTCTTGGT -> TCTTCGATCCCTCTTGGTT
GTGAACCGTACTTACACCA -> TGAACCGTACTTACACCAC
GTGAAGAATCTTTGAAGGG -> TGAAGAATCTTTGAAGGGC
GTGAATACGTCACACCTCG -> TGAATACGTCACACCTCGG
GTGACCGGGATGGTCTGAG -> TGACCGGGATGGTCTGAGT
GTGACGGATAGCAGTATAG -> TGACGGATAGCAGTATAGC
GTGACGTCCAGTCGATGGC -> TGACGTCCAGTCGATGGCA
GTGACTATTGGATGCGTTT -> TGACTATTGGATGCGTTTG
GTGATAGTCACTCGGACTG -> TGATAGTCACTCGGACTGT
GTGATATCTGCCAAGAATG -> TGATATCTGCCAAGAATGA
GTGATCCTGTAACCACCGT -> TGATCCTGTAACCACCGTA
GTGATCGACTACATTGATT -> TGATCGACTACATTGATTT
GTGATCGCTTGCACACCAT -> TGATCGCTTGCACACCATG
GTGATTTTGTACGTCGGTA -> TGATTTTGTACGTCGGTAC
GTGCAAAATATTGTCGGTG -> TGCAAAATATTGTCGGTGG
GTGCCGTCTGGATAGGGCT -> TGCCGTCTGGATAGGGCTG
GTGCCTGGCTTCAGCATGA -> TGCCTGGCTTCAGCATGAG
GTGCTACTTTTCTCAACGA -> TGCTACTTTTCTCAACGAC
GTGCTTAGACACCAGATCC -> TGCTTAGACACCAGATCCC
GTGGAGAGCTAGGCTTCGC -> TGGAGAGCTAGGCTTCGCC
GTGGCGTAGCGCCGCGCAA -> TGGCGTAGCGCCGCGCAAC
GTGGGAAACTTTGCGCCAT -> TGGGAAACTTTGCGCCATG
GTGGGCGTGTCTTCGATCC -> TGGGCGTGTCTTCGATCCC
GTGGGCGTTCCGAATAACG -> TGGGCGTTCCGAATAACGT
GTGGGCGTTCCGAATACTT -> TGGGCGTTCCGAATACTTT
GTGGGCGTTCCGAATAGGA -> TGGGCGTTCCGAATAGGAA
GTGGGCGTTCCGAATATCA -> TGGGCGTTCCGAATATCAT
GTGGGTTCATTCCCCATGA -> TGGGTTCATTCCCCATGAA
GTGGGTTGCAGTCTAAGTG -> TGGGTTGCAGTCTAAGTGT
GTGGTAAATGCTAATGGTT -> TGGTAAATGCTAATGGTTG
GTGTATGCAAGACTTGTAT -> TGTATGCAAGACTTGTATG
GTGTCCACAATCAATTGAA -> TGTCCACAATCAATTGAAA
GTGTCCGATTGTTATACGA -> TGTCCGATTGTTATACGAG
GTGTCCGCGAGTTGGCGCC -> TGTCCGCGAGTTGGCGCCA
GTGTCCGGGTGTATGCAAG -> TGTCCGGGTGTATGCAAGA
GTGTCGAACAAAGACGCAG -> TGTCGAACAAAGACGCAGT
GTGTCTTCGATCCCTCTTG -> TGTCTTCGATCCCTCTTGG
GTGTGACGGATAGCAGTAT -> TGTGACGGATAGCAGTATA
GTGTGTCCGGGTGTATGCA -> TGTGTCCGGGTGTATGCAA
GTTAATACTAGCCTGGGTA -> TTAATACTAGCCTGGGTAA
GTTACACCATCGACCCAAC -> TTACACCATCGACCCAACC
GTTACGGGTACAGAAGGAT -> TTACGGGTACAGAAGGATG
GTTAGGCCAACCGTTTAAT -> TTAGGCCAACCGTTTAATC
GTTAGTTGGGCTTACGAGT -> TTAGTTGGGCTTACGAGTG
GTTATACGAGCCTCGTGTC -> TTATACGAGCCTCGTGTCG
GTTCAAAGTGATAGTCACT -> TTCAAAGTGATAGTCACTC
GTTCAAATTGTATCATGCC -> TTCAAATTGTATCATGCCG
GTTCACTTGAAGGCCCGAG -> TTCACTTGAAGGCCCGAGG
GTTCATCCGGTGGGCGTTC -> TTCATCCGGTGGGCGTTCC
GTTCATTCCCCATGAATTT -> TTCATTCCCCATGAATTTA
GTTCCGAATAACGTGCAAA -> TTCCGAATAACGTGCAAAA
GTTCCGAATACTTTTACTC -> TTCCGAATACTTTTACTCA
GTTCCGAATAGGAAAACTC -> TTCCGAATAGGAAAACTCC
GTTCCGAATATCATCCATA -> TTCCGAATATCATCCATAT
GTTCGAGGCTAACGCGGGA -> TTCGAGGCTAACGCGGGAA
GTTCGTTGCGGTTCATCCG -> TTCGTTGCGGTTCATCCGG
GTTCTGCGTAAGTCAGAGT -> TTCTGCGTAAGTCAGAGTT
GTTGAATTCATTGCGGGAC -> TTGAATTCATTGCGGGACC
GTTGACAATTTCATCATCG -> TTGACAATTTCATCATCGT
GTTGATGACCGTACAGGCA -> TTGATGACCGTACAGGCAA
GTTGCAGTCTAAGTGTCCG -> TTGCAGTCTAAGTGTCCGA
GTTGCCAGCAACTACGGCC -> TTGCCAGCAACTACGGCCT
GTTGCCCAAAGGCCTAATC -> TTGCCCAAAGGCCTAATCT
GTTGCCCAGGGATCAGCGC -> TTGCCCAGGGATCAGCGCC
GTTGCGGTTCATCCGGTGG -> TTGCGGTTCATCCGGTGGG
GTTGGCGCCAACAATGCCT -> TTGGCGCCAACAATGCCTG
GTTGGGCTTACGAGTGACG -> TTGGGCTTACGAGTGACGT
GTTTAAAAGGACTTTCAGA -> TTTAAAAGGACTTTCAGAT
GTTTAATCTGGATCTACTC -> TTTAATCTGGATCTACTCC
GTTTAGTTAATACTAGCCT -> TTTAGTTAATACTAGCCTG
GTTTGCAATGTTACGGGTA -> TTTGCAATGTTACGGGTAC
GTTTGGGGTAGGCACGTGG -> TTTGGGGTAGGCACGTGGG
GTTTGTACGTAGAACTGCT -> TTTGTACGTAGAACTGCTG
GTTTTTGTGCCGTCTGGAT -> TTTTTGTGCCGTCTGGATA
TAAAAGGACTTTCAGATTA -> AAAAGGACTTTCAGATTAA
TAAAAGGTGGGCGTGTCTT -> AAAAGGTGGGCGTGTCTTC
TAAACACGGTGGGCGTTCC -> AAACACGGTGGGCGTTCCG
TAAAGTAAGTAAGAGACTT -> AAAGTAAGTAAGAGACTTA
TAAATGCTAATGGTTGATG -> AAATGCTAATGGTTGATGA
TAACAGGTGAATACGTCAC -> AACAGGTGAATACGTCACA
TAACCACCGTATAAAGTAA -> AACCACCGTATAAAGTAAG
TAACCTAATATTTCGAGAG -> AACCTAATATTTCGAGAGA
TAACGCGGGAAACGTCGGG -> AACGCGGGAAACGTCGGGA
TAACGTGCAAAATATTGTC -> AACGTGCAAAATATTGTCG
TAACTCCTTGTACTAATAT -> AACTCCTTGTACTAATATT
TAACTGATGGTGATTTTGT -> AACTGATGGTGATTTTGTA
TAAGAGACTTAGCGCCACC -> AAGAGACTTAGCGCCACCG
TAAGCACGTTAGGCCAACC -> AAGCACGTTAGGCCAACCG
TAAGCGGCTGAATCGCAAA -> AAGCGGCTGAATCGCAAAG
TAAGCGGGTAGGTGATCCT -> AAGCGGGTAGGTGATCCTG
TAAGTAAGAGACTTAGCGC -> AAGTAAGAGACTTAGCGCC
TAAGTAAGTCGCCAATGCC -> AAGTAAGTCGCCAATGCCT
TAAGTCAGAGTTCACTTGA -> AAGTCAGAGTTCACTTGAA
TAAGTCGCCAATGCCTACG -> AAGTCGCCAATGCCTACGG
TAAGTGTCCGATTGTTATA -> AAGTGTCCGATTGTTATAC
TAATACTAGCCTGGGTAAA -> AATACTAGCCTGGGTAAAA
TAATAGTGACCGGGATGGT -> AATAGTGACCGGGATGGTC
TAATATTCAAGAAATAGGT -> AATATTCAAGAAATAGGTT
TAATATTTCGAGAGATCGC -> AATATTTCGAGAGATCGCG
TAATCAAGCGAACTCCTCA -> AATCAAGCGAACTCCTCAC
TAATCCAGGAAGAACAAAA -> AATCCAGGAAGAACAAAAG
TAATCTCTACCCACTTTCA -> AATCTCTACCCACTTTCAG
TAATCTGGATCTACTCCCC -> AATCTGGATCTACTCCCCA
TAATCTTTTCCTAACTCCT -> AATCTTTTCCTAACTCCTT
TAATGGTTGATGACCGTAC -> AATGGTTGATGACCGTACA
TAATTGCCACAGCTCTTAC -> AATTGCCACAGCTCTTACA
TACAAAGACTTTAGTGGGT -> ACAAAGACTTTAGTGGGTT
TACACAGATGGTGTGACGG -> ACACAGATGGTGTGACGGA
TACACCACACTGGACTACA -> ACACCACACTGGACTACAA
TACACCATCGACCCAACCG -> ACACCATCGACCCAACCGC
TACACCCACAGCTCTTACA -> ACACCCACAGCTCTTACAC
TACACGCCACAGCTCTTAC -> ACACGCCACAGCTCTTACA
TACACTTCGGGGAAGTTCA -> ACACTTCGGGGAAGTTCAA
TACAGAAGGATGCTATCGC -> ACAGAAGGATGCTATCGCT
TACAGGCAAAGTTGAATTC -> ACAGGCAAAGTTGAATTCA
TACATTCCGTAGGTCAATT -> ACATTCCGTAGGTCAATTA
TACATTGATTTTCGTTGCC -> ACATTGATTTTCGTTGCCC
TACCCACTTTCAGGGAGTA -> ACCCACTTTCAGGGAGTAC
TACCGCGGGAGAATTATCT -> ACCGCGGGAGAATTATCTT
TACCGGGAACCCTAGGGAG -> ACCGGGAACCCTAGGGAGT
TACCGGTAGACCTCTTTAT -> ACCGGTAGACCTCTTTATT
TACCTGGAGATCTTCTGTA -> ACCTGGAGATCTTCTGTAT
TACCTGTCTCTCCGAGATG -> ACCTGTCTCTCCGAGATGA
TACCTTCAACTTAACAGGT -> ACCTTCAACTTAACAGGTG
TACGAGCCTCGTGTCGAAC -> ACGAGCCTCGTGTCGAACA
TACGAGTGACGTCCAGTCG -> ACGAGTGACGTCCAGTCGA
TACGGACTGTTACACCATC -> ACGGACTGTTACACCATCG
TACGGCCTCATTGTTGACA -> ACGGCCTCATTGTTGACAA
TACGGGTACAGAAGGATGC -> ACGGGTACAGAAGGATGCT
TACGTAATCAAGCGAACTC -> ACGTAATCAAGCGAACTCC
TACGTAGAACTGCTGCAAA -> ACGTAGAACTGCTGCAAAG
TACGTCACACCTCGGTTTA -> ACGTCACACCTCGGTTTAG
TACGTCGGTACGTAATCAA -> ACGTCGGTACGTAATCAAG
TACTAATATTCAAGAAATA -> ACTAATATTCAAGAAATAG
TACTAGCCTGGGTAAAAGG -> ACTAGCCTGGGTAAAAGGT
TACTCACATGATTCTTCAT -> ACTCACATGATTCTTCATC
TACTCACCGGGTGACTATT -> ACTCACCGGGTGACTATTG
TACTCAGATTGCGGTGGGC -> ACTCAGATTGCGGTGGGCG
TACTCCCCAAGTGGAGAGC -> ACTCCCCAAGTGGAGAGCT
TACTCTTGCCATTACCTTC -> ACTCTTGCCATTACCTTCA
TACTTACACCACACTGGAC -> ACTTACACCACACTGGACT
TACTTTTACTCAGATTGCG -> ACTTTTACTCAGATTGCGG
TACTTTTCTCAACGACCAT -> ACTTTTCTCAACGACCATT
TAGAACTGCTGCAAAGTGA -> AGAACTGCTGCAAAGTGAA
TAGACACCAGATCCCTTTA -> AGACACCAGATCCCTTTAC
TAGACCTCTTTATTCGGGG -> AGACCTCTTTATTCGGGGA
TAGAGCTGGCCCACGAGTT -> AGAGCTGGCCCACGAGTTC
TAGCAGTATAGCGTTAGTT -> AGCAGTATAGCGTTAGTTG
TAGCCTGGGTAAAAGGTGG -> AGCCTGGGTAAAAGGTGGG
TAGCGCAGCTCGCCAAGGT -> AGCGCAGCTCGCCAAGGTC
TAGCGCCACCGCCCTGCGT -> AGCGCCACCGCCCTGCGTC
TAGCGCCGCGCAACAAGTG -> AGCGCCGCGCAACAAGTGT
TAGCGTTAGTTGGGCTTAC -> AGCGTTAGTTGGGCTTACG
TAGGAAAACTCCTATTGCC -> AGGAAAACTCCTATTGCCA
TAGGCAATGCTAAGCACGT -> AGGCAATGCTAAGCACGTT
TAGGCACGTGGGTTCATTC -> AGGCACGTGGGTTCATTCC
TAGGCCAACCGTTTAATCT -> AGGCCAACCGTTTAATCTG
TAGGCGATGCTGTGATCGC -> AGGCGATGCTGTGATCGCT
TAGGCTTCGCCGAATATAT -> AGGCTTCGCCGAATATATC
TAGGGAGTGATATCTGCCA -> AGGGAGTGATATCTGCCAA
TAGGGCTGTGGTAAATGCT -> AGGGCTGTGGTAAATGCTA
TAGGGTACCTGTCTCTCCG -> AGGGTACCTGTCTCTCCGA
TAGGTAGTTCTGCGTAAGT -> AGGTAGTTCTGCGTAAGTC
TAGGTCAATTATTGATGAC -> AGGTCAATTATTGATGACG
TAGGTGATCCTGTAACCAC -> AGGTGATCCTGTAACCACC
TAGGTTTGCAATGTTACGG -> AGGTTTGCAATGTTACGGG
TAGTCACTCGGACTGTTCG -> AGTCACTCGGACTGTTCGA
TAGTCCTCAGAGGGCAGCC -> AGTCCTCAGAGGGCAGCCA
TAGTCGCCAAGACACGTGC -> AGTCGCCAAGACACGTGCT
TAGTGACCGGGATGGTCTG -> AGTGACCGGGATGGTCTGA
TAGTGGGTTGCAGTCTAAG -> AGTGGGTTGCAGTCTAAGT
TAGTTAATACTAGCCTGGG -> AGTTAATACTAGCCTGGGT
TAGTTCTGCGTAAGTCAGA -> AGTTCTGCGTAAGTCAGAG
TAGTTGGGCTTACGAGTGA -> AGTTGGGCTTACGAGTGAC
TATAAAGTAAGTAAGAGAC -> ATAAAGTAAGTAAGAGACT
TATAACTGATGGTGATTTT -> ATAACTGATGGTGATTTTG
TATAATTGCCACAGCTCTT -> ATAATTGCCACAGCTCTTA
TATACGAGCCTCGTGTCGA -> ATACGAGCCTCGTGTCGAA
TATACTCACCGGGTGACTA -> ATACTCACCGGGTGACTAT
TATAGCGTTAGTTGGGCTT -> ATAGCGTTAGTTGGGCTTA
TATATCCTTCAGACAATAA -> ATATCCTTCAGACAATAAA
TATCAACTTTAGGCAATGC -> ATCAACTTTAGGCAATGCT
TATCATCCATATAATTGCC -> ATCATCCATATAATTGCCA
TATCATGCCGGGAGTTGCC -> ATCATGCCGGGAGTTGCCC
TATCCTTCAGACAATAAAC -> ATCCTTCAGACAATAAACA
TATCCTTGCAATGCAAAAG -> ATCCTTGCAATGCAAAAGA
TATCGCTAGGCGATGCTGT -> ATCGCTAGGCGATGCTGTG
TATCTGCCAAGAATGATTT -> ATCTGCCAAGAATGATTTC
TATCTTGAAGAGGTAGTCC -> ATCTTGAAGAGGTAGTCCT
TATGATCTCGCCTATCCTT -> ATGATCTCGCCTATCCTTG
TATGCAAGACTTGTATGAT -> ATGCAAGACTTGTATGATC
TATGTGCTACTTTTCTCAA -> ATGTGCTACTTTTCTCAAC
TATTCAAGAAATAGGTTTG -> ATTCAAGAAATAGGTTTGC
TATTCGGGGAATACATTCC -> ATTCGGGGAATACATTCCG
TATTGATGACGACAACATA -> ATTGATGACGACAACATAC
TATTGCCACAGCTCTTACA -> ATTGCCACAGCTCTTACAC
TATTGGATGCGTTTGTACG -> ATTGGATGCGTTTGTACGT
TATTGTCGGTGGGCGTTCC -> ATTGTCGGTGGGCGTTCCG
TATTTCGAGAGATCGCGCT -> ATTTCGAGAGATCGCGCTA
TCAAAGTGATAGTCACTCG -> CAAAGTGATAGTCACTCGG
TCAAATTGTATCATGCCGG -> CAAATTGTATCATGCCGGG
TCAACGACCATTTCGCTCG -> CAACGACCATTTCGCTCGT
TCAACTTAACAGGTGAATA -> CAACTTAACAGGTGAATAC
TCAACTTTAGGCAATGCTA -> CAACTTTAGGCAATGCTAA
TCAAGAAATAGGTTTGCAA -> CAAGAAATAGGTTTGCAAT
TCAAGCGAACTCCTCACGC -> CAAGCGAACTCCTCACGCA
TCAATCTCGGTCCCTGGAA -> CAATCTCGGTCCCTGGAAA
TCAATTATTGATGACGACA -> CAATTATTGATGACGACAA
TCAATTGAAATTAGAGCTG -> CAATTGAAATTAGAGCTGG
TCACACCTCGGTTTAGTTA -> CACACCTCGGTTTAGTTAA
TCACACGACTGGAGTAGGG -> CACACGACTGGAGTAGGGT
TCACATGATTCTTCATCAC -> CACATGATTCTTCATCACA
TCACATGCGGTTTGGGGTA -> CACATGCGGTTTGGGGTAG
TCACATGTTGCCAGCAACT -> CACATGTTGCCAGCAACTA
TCACCGGGTGACTATTGGA -> CACCGGGTGACTATTGGAT
TCACGCACCTCCCGGTAAT -> CACGCACCTCCCGGTAATC
TCACTCGGACTGTTCGAGG -> CACTCGGACTGTTCGAGGC
TCACTCTTCACATGCGGTT -> CACTCTTCACATGCGGTTT
TCACTTGAAGGCCCGAGGT -> CACTTGAAGGCCCGAGGTA
TCAGACAATAAACACGGTG -> CAGACAATAAACACGGTGG
TCAGAGCGCAAAGCGCTAA -> CAGAGCGCAAAGCGCTAAG
TCAGAGGGCAGCCAACTCA -> CAGAGGGCAGCCAACTCAT
TCAGAGTTCACTTGAAGGC -> CAGAGTTCACTTGAAGGCC
TCAGATTAAGCGGGTAGGT -> CAGATTAAGCGGGTAGGTG
TCAGATTGACCCGCCCTAT -> CAGATTGACCCGCCCTATA
TCAGATTGCGGTGGGCGTT -> CAGATTGCGGTGGGCGTTC
TCAGCATGAGGATCCGGGA -> CAGCATGAGGATCCGGGAG
TCAGCGCCGCTCACATGTT -> CAGCGCCGCTCACATGTTG
TCAGGGAGTACTCACATGA -> CAGGGAGTACTCACATGAT
TCATCACACGACTGGAGTA -> CATCACACGACTGGAGTAG
TCATCATCGTGGCGTAGCG -> CATCATCGTGGCGTAGCGC
TCATCCATATAATTGCCAC -> CATCCATATAATTGCCACA
TCATCCGGTGGGCGTTCCG -> CATCCGGTGGGCGTTCCGA
TCATCGTGGCGTAGCGCCG -> CATCGTGGCGTAGCGCCGC
TCATGAGGACTCCGTGGGA -> CATGAGGACTCCGTGGGAA
TCATGCCGGGAGTTGCCCA -> CATGCCGGGAGTTGCCCAA
TCATTCCCCATGAATTTAT -> CATTCCCCATGAATTTATA
TCATTGCGGGACCTTCGGT -> CATTGCGGGACCTTCGGTG
TCATTGTTGACAATTTCAT -> CATTGTTGACAATTTCATC
TCCAAAAGAACCGTACCGG -> CCAAAAGAACCGTACCGGT
TCCACAATCAATTGAAATT -> CCACAATCAATTGAAATTA
TCCAGGAAGAACAAAAGAG -> CCAGGAAGAACAAAAGAGA
TCCAGTCGATGGCAGATTG -> CCAGTCGATGGCAGATTGA
TCCATATAATTGCCACAGC -> CCATATAATTGCCACAGCT
TCCCACAGATCCCCGATTC -> CCCACAGATCCCCGATTCA
TCCCCAAGTGGAGAGCTAG -> CCCCAAGTGGAGAGCTAGG
TCCCCATGAATTTATACTC -> CCCCATGAATTTATACTCA
TCCCCGATTCAATCTCGGT -> CCCCGATTCAATCTCGGTC
TCCCGGTAATCTTTTCCTA -> CCCGGTAATCTTTTCCTAA
TCCCTCTTGGTTATTCGTC -> CCCTCTTGGTTATTCGTCA
TCCCTGGAAACTTTGGTTT -> CCCTGGAAACTTTGGTTTT
TCCCTTTACCGCGGGAGAA -> CCCTTTACCGCGGGAGAAT
TCCGAATAACGTGCAAAAT -> CCGAATAACGTGCAAAATA
TCCGAATACTTTTACTCAG -> CCGAATACTTTTACTCAGA
TCCGAATAGGAAAACTCCT -> CCGAATAGGAAAACTCCTA
TCCGAATATCATCCATATA -> CCGAATATCATCCATATAA
TCCGAGATGAGCCCTCCCA -> CCGAGATGAGCCCTCCCAC
TCCGATTGTTATACGAGCC -> CCGATTGTTATACGAGCCT
TCCGCGAGTTGGCGCCAAC -> CCGCGAGTTGGCGCCAACA
TCCGGAGGTTTAAAAGGAC -> CCGGAGGTTTAAAAGGACT
TCCGGGAGAGTAATAGTGA -> CCGGGAGAGTAATAGTGAC
TCCGGGTGTATGCAAGACT -> CCGGGTGTATGCAAGACTT
TCCGGTGGGCGTTCCGAAT -> CCGGTGGGCGTTCCGAATA
TCCGGTGTCCACAATCAAT -> CCGGTGTCCACAATCAATT
TCCGTAGGTCAATTATTGA -> CCGTAGGTCAATTATTGAT
TCCGTGGGAAACTTTGCGC -> CCGTGGGAAACTTTGCGCC
TCCGTTCAAAGTGATAGTC -> CCGTTCAAAGTGATAGTCA
TCCTAACTCCTTGTACTAA -> CCTAACTCCTTGTACTAAT
TCCTATTGCCACAGCTCTT -> CCTATTGCCACAGCTCTTA
TCCTCACGCACCTCCCGGT -> CCTCACGCACCTCCCGGTA
TCCTCAGAGGGCAGCCAAC -> CCTCAGAGGGCAGCCAACT
TCCTGTAACCACCGTATAA -> CCTGTAACCACCGTATAAA
TCCTTCAGACAATAAACAC -> CCTTCAGACAATAAACACG
TCCTTGCAATGCAAAAGAG -> CCTTGCAATGCAAAAGAGA
TCCTTGTACTAATATTCAA -> CCTTGTACTAATATTCAAG
TCGAACAAAGACGCAGTAA -> CGAACAAAGACGCAGTAAT
TCGAATGGCCAACGGAAAC -> CGAATGGCCAACGGAAACC
TCGACCCAACCGCCGCCGT -> CGACCCAACCGCCGCCGTG
TCGACTACATTGATTTTCG -> CGACTACATTGATTTTCGT
TCGAGAGATCGCGCTAGCG -> CGAGAGATCGCGCTAGCGC
TCGAGGCTAACGCGGGAAA -> CGAGGCTAACGCGGGAAAC
TCGATCCCTCTTGGTTATT -> CGATCCCTCTTGGTTATTC
TCGATGGCAGATTGATGAG -> CGATGGCAGATTGATGAGA
TCGCAAAGAGCGAAGACGT -> CGCAAAGAGCGAAGACGTG
TCGCAACGCTCAGAGCGCA -> CGCAACGCTCAGAGCGCAA
TCGCATTCGAATGGCCAAC -> CGCATTCGAATGGCCAACG
TCGCCAAGACACGTGCTTA -> CGCCAAGACACGTGCTTAG
TCGCCAAGGTCCGGAGGTT -> CGCCAAGGTCCGGAGGTTT
TCGCCAATGCCTACGGACT -> CGCCAATGCCTACGGACTG
TCGCCGAATATATCCTTCA -> CGCCGAATATATCCTTCAG
TCGCCTATCCTTGCAATGC -> CGCCTATCCTTGCAATGCA
TCGCGCTAGCGCAGCTCGC -> CGCGCTAGCGCAGCTCGCC
TCGCTAGGCGATGCTGTGA -> CGCTAGGCGATGCTGTGAT
TCGCTCGTGCCTGGCTTCA -> CGCTCGTGCCTGGCTTCAG
TCGCTTGCACACCATGTCG -> CGCTTGCACACCATGTCGC
TCGGACTGTTCGAGGCTAA -> CGGACTGTTCGAGGCTAAC
TCGGCAGGGACAGATGTAG -> CGGCAGGGACAGATGTAGT
TCGGGATTACCTGGAGATC -> CGGGATTACCTGGAGATCT
TCGGGGAAGTTCAAATTGT -> CGGGGAAGTTCAAATTGTA
TCGGGGAATACATTCCGTA -> CGGGGAATACATTCCGTAG
TCGGGGATTATGTGCTACT -> CGGGGATTATGTGCTACTT
TCGGTACGTAATCAAGCGA -> CGGTACGTAATCAAGCGAA
TCGGTCCCTGGAAACTTTG -> CGGTCCCTGGAAACTTTGG
TCGGTGGGCGTTCCGAATA -> CGGTGGGCGTTCCGAATAT
TCGGTGTGTCCGGGTGTAT -> CGGTGTGTCCGGGTGTATG
TCGGTTTAGTTAATACTAG -> CGGTTTAGTTAATACTAGC
TCGTGCCTGGCTTCAGCAT -> CGTGCCTGGCTTCAGCATG
TCGTGGCGTAGCGCCGCGC -> CGTGGCGTAGCGCCGCGCA
TCGTGTCGAACAAAGACGC -> CGTGTCGAACAAAGACGCA
TCGTTGCCCAGGGATCAGC -> CGTTGCCCAGGGATCAGCG
TCGTTGCGGTTCATCCGGT -> CGTTGCGGTTCATCCGGTG
TCTAAGTGTCCGATTGTTA -> CTAAGTGTCCGATTGTTAT
TCTACCCACTTTCAGGGAG -> CTACCCACTTTCAGGGAGT
TCTACTCCCCAAGTGGAGA -> CTACTCCCCAAGTGGAGAG
TCTCAACGACCATTTCGCT -> CTCAACGACCATTTCGCTC
TCTCCGAGATGAGCCCTCC -> CTCCGAGATGAGCCCTCCC
TCTCGCCTATCCTTGCAAT -> CTCGCCTATCCTTGCAATG
TCTCGGTCCCTGGAAACTT -> CTCGGTCCCTGGAAACTTT
TCTCTACCCACTTTCAGGG -> CTCTACCCACTTTCAGGGA
TCTCTCCGAGATGAGCCCT -> CTCTCCGAGATGAGCCCTC
TCTGAGTCGGCAGGGACAG -> CTGAGTCGGCAGGGACAGA
TCTGCCAAGAATGATTTCG -> CTGCCAAGAATGATTTCGC
TCTGCGTAAGTCAGAGTTC -> CTGCGTAAGTCAGAGTTCA
TCTGGATAGGGCTGTGGTA -> CTGGATAGGGCTGTGGTAA
TCTGGATCTACTCCCCAAG -> CTGGATCTACTCCCCAAGT
TCTGTATCAACTTTAGGCA -> CTGTATCAACTTTAGGCAA
TCTTACACAGATGGTGTGA -> CTTACACAGATGGTGTGAC
TCTTACACCCACAGCTCTT -> CTTACACCCACAGCTCTTA
TCTTACACGCCACAGCTCT -> CTTACACGCCACAGCTCTT
TCTTACACTTCGGGGAAGT -> CTTACACTTCGGGGAAGTT
TCTTCACATGCGGTTTGGG -> CTTCACATGCGGTTTGGGG
TCTTCATCACACGACTGGA -> CTTCATCACACGACTGGAG
TCTTCGATCCCTCTTGGTT -> CTTCGATCCCTCTTGGTTA
TCTTCTGTATCAACTTTAG -> CTTCTGTATCAACTTTAGG
TCTTGAAGAGGTAGTCCTC -> CTTGAAGAGGTAGTCCTCA
TCTTGCCATTACCTTCAAC -> CTTGCCATTACCTTCAACT
TCTTTATTCGGGGAATACA -> CTTTATTCGGGGAATACAT
TCTTTGAAGGGCGGTCCGG -> CTTTGAAGGGCGGTCCGGT
TCTTTTCCTAACTCCTTGT -> CTTTTCCTAACTCCTTGTA
TGAAATTAGAGCTGGCCCA -> GAAATTAGAGCTGGCCCAC
TGAACCGTACTTACACCAC -> GAACCGTACTTACACCACA
TGAAGAATCTTTGAAGGGC -> GAAGAATCTTTGAAGGGCG
TGAAGAGGTAGTCCTCAGA -> GAAGAGGTAGTCCTCAGAG
TGAAGGCCCGAGGTAACCT -> GAAGGCCCGAGGTAACCTA
TGAAGGGCGGTCCGGTGTC -> GAAGGGCGGTCCGGTGTCC
TGAATACGTCACACCTCGG -> GAATACGTCACACCTCGGT
TGAATCGCAAAGAGCGAAG -> GAATCGCAAAGAGCGAAGA
TGAATTCATTGCGGGACCT -> GAATTCATTGCGGGACCTT
TGAATTTATACTCACCGGG -> GAATTTATACTCACCGGGT
TGACAACAGTACTCTTGCC -> GACAACAGTACTCTTGCCA
TGACAATTTCATCATCGTG -> GACAATTTCATCATCGTGG
TGACCCGCCCTATAACTGA -> GACCCGCCCTATAACTGAT
TGACCGGGATGGTCTGAGT -> GACCGGGATGGTCTGAGTC
TGACCGTACAGGCAAAGTT -> GACCGTACAGGCAAAGTTG
TGACGACAACATACCGGGA -> GACGACAACATACCGGGAA
TGACGGATAGCAGTATAGC -> GACGGATAGCAGTATAGCG
TGACGTCCAGTCGATGGCA -> GACGTCCAGTCGATGGCAG
TGACTATTGGATGCGTTTG -> GACTATTGGATGCGTTTGT
TGAGAATAGGTAGTTCTGC -> GAGAATAGGTAGTTCTGCG
TGAGCCCTCCCACAGATCC -> GAGCCCTCCCACAGATCCC
TGAGGACTCCGTGGGAAAC -> GAGGACTCCGTGGGAAACT
TGAGGATCCGGGAGAGTAA -> GAGGATCCGGGAGAGTAAT
TGAGTCGGCAGGGACAGAT -> GAGTCGGCAGGGACAGATG
TGATAGTCACTCGGACTGT -> GATAGTCACTCGGACTGTT
TGATATCTGCCAAGAATGA -> GATATCTGCCAAGAATGAT
TGATCCTGTAACCACCGTA -> GATCCTGTAACCACCGTAT
TGATCGACTACATTGATTT -> GATCGACTACATTGATTTT
TGATCGCTTGCACACCATG -> GATCGCTTGCACACCATGT
TGATCTCGCCTATCCTTGC -> GATCTCGCCTATCCTTGCA
TGATGACCGTACAGGCAAA -> GATGACCGTACAGGCAAAG
TGATGACGACAACATACCG -> GATGACGACAACATACCGG
TGATGAGAATAGGTAGTTC -> GATGAGAATAGGTAGTTCT
TGATGGTGATTTTGTACGT -> GATGGTGATTTTGTACGTC
TGATTCTTCATCACACGAC -> GATTCTTCATCACACGACT
TGATTTCGCATTCGAATGG -> GATTTCGCATTCGAATGGC
TGATTTTCGTTGCCCAGGG -> GATTTTCGTTGCCCAGGGA
TGATTTTGTACGTCGGTAC -> GATTTTGTACGTCGGTACG
TGCAAAAGAGAAGTAAGTA -> GCAAAAGAGAAGTAAGTAA
TGCAAAATATTGTCGGTGG -> GCAAAATATTGTCGGTGGG
TGCAAAGTGAAGAATCTTT -> GCAAAGTGAAGAATCTTTG
TGCAAGACTTGTATGATCT -> GCAAGACTTGTATGATCTC
TGCAATGCAAAAGAGAAGT -> GCAATGCAAAAGAGAAGTA
TGCAATGTTACGGGTACAG -> GCAATGTTACGGGTACAGA
TGCACACCATGTCGCAACG -> GCACACCATGTCGCAACGC
TGCAGTCTAAGTGTCCGAT -> GCAGTCTAAGTGTCCGATT
TGCCAAGAATGATTTCGCA -> GCCAAGAATGATTTCGCAT
TGCCACAGCTCTTACACCC -> GCCACAGCTCTTACACCCA
TGCCACAGCTCTTACACGC -> GCCACAGCTCTTACACGCC
TGCCAGCAACTACGGCCTC -> GCCAGCAACTACGGCCTCA
TGCCATTACCTTCAACTTA -> GCCATTACCTTCAACTTAA
TGCCCAAAGGCCTAATCTC -> GCCCAAAGGCCTAATCTCT
TGCCCAGGGATCAGCGCCG -> GCCCAGGGATCAGCGCCGC
TGCCGGGAGTTGCCCAAAG -> GCCGGGAGTTGCCCAAAGG
TGCCGTCTGGATAGGGCTG -> GCCGTCTGGATAGGGCTGT
TGCCTACGGACTGTTACAC -> GCCTACGGACTGTTACACC
TGCCTGGCTTCAGCATGAG -> GCCTGGCTTCAGCATGAGG
TGCCTGTCCGTTCAAAGTG -> GCCTGTCCGTTCAAAGTGA
TGCGCCATGACAACAGTAC -> GCGCCATGACAACAGTACT
TGCGGGACCTTCGGTGTGT -> GCGGGACCTTCGGTGTGTC
TGCGGTGGGCGTTCCGAAT -> GCGGTGGGCGTTCCGAATA
TGCGGTTCATCCGGTGGGC -> GCGGTTCATCCGGTGGGCG
TGCGGTTTGGGGTAGGCAC -> GCGGTTTGGGGTAGGCACG
TGCGTAAGTCAGAGTTCAC -> GCGTAAGTCAGAGTTCACT
TGCGTCCAAAAGAACCGTA -> GCGTCCAAAAGAACCGTAC
TGCGTTTGTACGTAGAACT -> GCGTTTGTACGTAGAACTG
TGCTAAGCACGTTAGGCCA -> GCTAAGCACGTTAGGCCAA
TGCTAATGGTTGATGACCG -> GCTAATGGTTGATGACCGT
TGCTACTTTTCTCAACGAC -> GCTACTTTTCTCAACGACC
TGCTATCGCTAGGCGATGC -> GCTATCGCTAGGCGATGCT
TGCTGCAAAGTGAAGAATC -> GCTGCAAAGTGAAGAATCT
TGCTGTGATCGCTTGCACA -> GCTGTGATCGCTTGCACAC
TGCTTAGACACCAGATCCC -> GCTTAGACACCAGATCCCT
TGGAAACTTTGGTTTTTGT -> GGAAACTTTGGTTTTTGTG
TGGACTACAAAGACTTTAG -> GGACTACAAAGACTTTAGT
TGGAGAGCTAGGCTTCGCC -> GGAGAGCTAGGCTTCGCCG
TGGAGATCTTCTGTATCAA -> GGAGATCTTCTGTATCAAC
TGGAGTAGGGTACCTGTCT -> GGAGTAGGGTACCTGTCTC
TGGATAGGGCTGTGGTAAA -> GGATAGGGCTGTGGTAAAT
TGGATCTACTCCCCAAGTG -> GGATCTACTCCCCAAGTGG
TGGATGCGTTTGTACGTAG -> GGATGCGTTTGTACGTAGA
TGGCAGATTGATGAGAATA -> GGCAGATTGATGAGAATAG
TGGCCAACGGAAACCGAGT -> GGCCAACGGAAACCGAGTC
TGGCCCACGAGTTCGTTGC -> GGCCCACGAGTTCGTTGCG
TGGCGCCAACAATGCCTGT -> GGCGCCAACAATGCCTGTC
TGGCGTAGCGCCGCGCAAC -> GGCGTAGCGCCGCGCAACA
TGGCTTCAGCATGAGGATC -> GGCTTCAGCATGAGGATCC
TGGGAAACTTTGCGCCATG -> GGGAAACTTTGCGCCATGA
TGGGCGTGTCTTCGATCCC -> GGGCGTGTCTTCGATCCCT
TGGGCGTTCCGAATAACGT -> GGGCGTTCCGAATAACGTG
TGGGCGTTCCGAATACTTT -> GGGCGTTCCGAATACTTTT
TGGGCGTTCCGAATAGGAA -> GGGCGTTCCGAATAGGAAA
TGGGCGTTCCGAATATCAT -> GGGCGTTCCGAATATCATC
TGGGCTTACGAGTGACGTC -> GGGCTTACGAGTGACGTCC
TGGGGTAGGCACGTGGGTT -> GGGGTAGGCACGTGGGTTC
TGGGTAAAAGGTGGGCGTG -> GGGTAAAAGGTGGGCGTGT
TGGGTTCATTCCCCATGAA -> GGGTTCATTCCCCATGAAT
TGGGTTGCAGTCTAAGTGT -> GGGTTGCAGTCTAAGTGTC
TGGTAAATGCTAATGGTTG -> GGTAAATGCTAATGGTTGA
TGGTCTGAGTCGGCAGGGA -> GGTCTGAGTCGGCAGGGAC
TGGTGATTTTGTACGTCGG -> GGTGATTTTGTACGTCGGT
TGGTGTGACGGATAGCAGT -> GGTGTGACGGATAGCAGTA
TGGTTGATGACCGTACAGG -> GGTTGATGACCGTACAGGC
TGGTTTTTGTGCCGTCTGG -> GGTTTTTGTGCCGTCTGGA
TGTAACCACCGTATAAAGT -> GTAACCACCGTATAAAGTA
TGTACGTAGAACTGCTGCA -> GTACGTAGAACTGCTGCAA
TGTACGTCGGTACGTAATC -> GTACGTCGGTACGTAATCA
TGTACTAATATTCAAGAAA -> GTACTAATATTCAAGAAAT
TGTAGTCGCCAAGACACGT -> GTAGTCGCCAAGACACGTG
TGTATCAACTTTAGGCAAT -> GTATCAACTTTAGGCAATG
TGTATCATGCCGGGAGTTG -> GTATCATGCCGGGAGTTGC
TGTATGATCTCGCCTATCC -> GTATGATCTCGCCTATCCT
TGTATGCAAGACTTGTATG -> GTATGCAAGACTTGTATGA
TGTCCACAATCAATTGAAA -> GTCCACAATCAATTGAAAT
TGTCCGATTGTTATACGAG -> GTCCGATTGTTATACGAGC
TGTCCGCGAGTTGGCGCCA -> GTCCGCGAGTTGGCGCCAA
TGTCCGGGTGTATGCAAGA -> GTCCGGGTGTATGCAAGAC
TGTCCGTTCAAAGTGATAG -> GTCCGTTCAAAGTGATAGT
TGTCGAACAAAGACGCAGT -> GTCGAACAAAGACGCAGTA
TGTCGCAACGCTCAGAGCG -> GTCGCAACGCTCAGAGCGC
TGTCGGTGGGCGTTCCGAA -> GTCGGTGGGCGTTCCGAAT
TGTCTCTCCGAGATGAGCC -> GTCTCTCCGAGATGAGCCC
TGTCTTCGATCCCTCTTGG -> GTCTTCGATCCCTCTTGGT
TGTGACGGATAGCAGTATA -> GTGACGGATAGCAGTATAG
TGTGATCGCTTGCACACCA -> GTGATCGCTTGCACACCAT
TGTGCCGTCTGGATAGGGC -> GTGCCGTCTGGATAGGGCT
TGTGCTACTTTTCTCAACG -> GTGCTACTTTTCTCAACGA
TGTGGTAAATGCTAATGGT -> GTGGTAAATGCTAATGGTT
TGTGTCCGGGTGTATGCAA -> GTGTCCGGGTGTATGCAAG
TGTTACACCATCGACCCAA -> GTTACACCATCGACCCAAC
TGTTACGGGTACAGAAGGA -> GTTACGGGTACAGAAGGAT
TGTTATACGAGCCTCGTGT -> GTTATACGAGCCTCGTGTC
TGTTCGAGGCTAACGCGGG -> GTTCGAGGCTAACGCGGGA
TGTTGACAATTTCATCATC -> GTTGACAATTTCATCATCG
TGTTGCCAGCAACTACGGC -> GTTGCCAGCAACTACGGCC
TTAAAAGGACTTTCAGATT -> TAAAAGGACTTTCAGATTA
TTAACAGGTGAATACGTCA -> TAACAGGTGAATACGTCAC
TTAAGCGGGTAGGTGATCC -> TAAGCGGGTAGGTGATCCT
TTAATACTAGCCTGGGTAA -> TAATACTAGCCTGGGTAAA
TTAATCTGGATCTACTCCC -> TAATCTGGATCTACTCCCC
TTACACAGATGGTGTGACG -> TACACAGATGGTGTGACGG
TTACACCACACTGGACTAC -> TACACCACACTGGACTACA
TTACACCATCGACCCAACC -> TACACCATCGACCCAACCG
TTACACCCACAGCTCTTAC -> TACACCCACAGCTCTTACA
TTACACGCCACAGCTCTTA -> TACACGCCACAGCTCTTAC
TTACACTTCGGGGAAGTTC -> TACACTTCGGGGAAGTTCA
TTACCGCGGGAGAATTATC -> TACCGCGGGAGAATTATCT
TTACCTGGAGATCTTCTGT -> TACCTGGAGATCTTCTGTA
TTACCTTCAACTTAACAGG -> TACCTTCAACTTAACAGGT
TTACGAGTGACGTCCAGTC -> TACGAGTGACGTCCAGTCG
TTACGGGTACAGAAGGATG -> TACGGGTACAGAAGGATGC
TTACTCAGATTGCGGTGGG -> TACTCAGATTGCGGTGGGC
TTAGACACCAGATCCCTTT -> TAGACACCAGATCCCTTTA
TTAGAGCTGGCCCACGAGT -> TAGAGCTGGCCCACGAGTT
TTAGCGCCACCGCCCTGCG -> TAGCGCCACCGCCCTGCGT
TTAGGCAATGCTAAGCACG -> TAGGCAATGCTAAGCACGT
TTAGGCCAACCGTTTAATC -> TAGGCCAACCGTTTAATCT
TTAGTGGGTTGCAGTCTAA -> TAGTGGGTTGCAGTCTAAG
TTAGTTAATACTAGCCTGG -> TAGTTAATACTAGCCTGGG
TTAGTTGGGCTTACGAGTG -> TAGTTGGGCTTACGAGTGA
TTATACGAGCCTCGTGTCG -> TATACGAGCCTCGTGTCGA
TTATACTCACCGGGTGACT -> TATACTCACCGGGTGACTA
TTATCTTGAAGAGGTAGTC -> TATCTTGAAGAGGTAGTCC
TTATGTGCTACTTTTCTCA -> TATGTGCTACTTTTCTCAA
TTATTCGGGGAATACATTC -> TATTCGGGGAATACATTCC
TTATTGATGACGACAACAT -> TATTGATGACGACAACATA
TTCAAAGTGATAGTCACTC -> TCAAAGTGATAGTCACTCG
TTCAAATTGTATCATGCCG -> TCAAATTGTATCATGCCGG
TTCAACTTAACAGGTGAAT -> TCAACTTAACAGGTGAATA
TTCAAGAAATAGGTTTGCA -> TCAAGAAATAGGTTTGCAA
TTCAATCTCGGTCCCTGGA -> TCAATCTCGGTCCCTGGAA
TTCACATGCGGTTTGGGGT -> TCACATGCGGTTTGGGGTA
TTCACTTGAAGGCCCGAGG -> TCACTTGAAGGCCCGAGGT
TTCAGACAATAAACACGGT -> TCAGACAATAAACACGGTG
TTCAGATTAAGCGGGTAGG -> TCAGATTAAGCGGGTAGGT
TTCAGCATGAGGATCCGGG -> TCAGCATGAGGATCCGGGA
TTCAGGGAGTACTCACATG -> TCAGGGAGTACTCACATGA
TTCATCACACGACTGGAGT -> TCATCACACGACTGGAGTA
TTCATCATCGTGGCGTAGC -> TCATCATCGTGGCGTAGCG
TTCATCCGGTGGGCGTTCC -> TCATCCGGTGGGCGTTCCG
TTCATTCCCCATGAATTTA -> TCATTCCCCATGAATTTAT
TTCATTGCGGGACCTTCGG -> TCATTGCGGGACCTTCGGT
TTCCCCATGAATTTATACT -> TCCCCATGAATTTATACTC
TTCCGAATAACGTGCAAAA -> TCCGAATAACGTGCAAAAT
TTCCGAATACTTTTACTCA -> TCCGAATACTTTTACTCAG
TTCCGAATAGGAAAACTCC -> TCCGAATAGGAAAACTCCT
TTCCGAATATCATCCATAT -> TCCGAATATCATCCATATA
TTCCGTAGGTCAATTATTG -> TCCGTAGGTCAATTATTGA
TTCCTAACTCCTTGTACTA -> TCCTAACTCCTTGTACTAA
TTCGAATGGCCAACGGAAA -> TCGAATGGCCAACGGAAAC
TTCGAGAGATCGCGCTAGC -> TCGAGAGATCGCGCTAGCG
TTCGAGGCTAACGCGGGAA -> TCGAGGCTAACGCGGGAAA
TTCGATCCCTCTTGGTTAT -> TCGATCCCTCTTGGTTATT
TTCGCATTCGAATGGCCAA -> TCGCATTCGAATGGCCAAC
TTCGCCGAATATATCCTTC -> TCGCCGAATATATCCTTCA
TTCGCTCGTGCCTGGCTTC -> TCGCTCGTGCCTGGCTTCA
TTCGGGGAAGTTCAAATTG -> TCGGGGAAGTTCAAATTGT
TTCGGGGAATACATTCCGT -> TCGGGGAATACATTCCGTA
TTCGGTGTGTCCGGGTGTA -> TCGGTGTGTCCGGGTGTAT
TTCGTTGCCCAGGGATCAG -> TCGTTGCCCAGGGATCAGC
TTCGTTGCGGTTCATCCGG -> TCGTTGCGGTTCATCCGGT
TTCTCAACGACCATTTCGC -> TCTCAACGACCATTTCGCT
TTCTGCGTAAGTCAGAGTT -> TCTGCGTAAGTCAGAGTTC
TTCTGTATCAACTTTAGGC -> TCTGTATCAACTTTAGGCA
TTCTTCATCACACGACTGG -> TCTTCATCACACGACTGGA
TTGAAATTAGAGCTGGCCC -> TGAAATTAGAGCTGGCCCA
TTGAAGAGGTAGTCCTCAG -> TGAAGAGGTAGTCCTCAGA
TTGAAGGCCCGAGGTAACC -> TGAAGGCCCGAGGTAACCT
TTGAAGGGCGGTCCGGTGT -> TGAAGGGCGGTCCGGTGTC
TTGAATTCATTGCGGGACC -> TGAATTCATTGCGGGACCT
TTGACAATTTCATCATCGT -> TGACAATTTCATCATCGTG
TTGACCCGCCCTATAACTG -> TGACCCGCCCTATAACTGA
TTGATGACCGTACAGGCAA -> TGATGACCGTACAGGCAAA
TTGATGACGACAACATACC -> TGATGACGACAACATACCG
TTGATGAGAATAGGTAGTT -> TGATGAGAATAGGTAGTTC
TTGATTTTCGTTGCCCAGG -> TGATTTTCGTTGCCCAGGG
TTGCAATGCAAAAGAGAAG -> TGCAATGCAAAAGAGAAGT
TTGCAATGTTACGGGTACA -> TGCAATGTTACGGGTACAG
TTGCACACCATGTCGCAAC -> TGCACACCATGTCGCAACG
TTGCAGTCTAAGTGTCCGA -> TGCAGTCTAAGTGTCCGAT
TTGCCACAGCTCTTACACC -> TGCCACAGCTCTTACACCC
TTGCCACAGCTCTTACACG -> TGCCACAGCTCTTACACGC
TTGCCAGCAACTACGGCCT -> TGCCAGCAACTACGGCCTC
TTGCCATTACCTTCAACTT -> TGCCATTACCTTCAACTTA
TTGCCCAAAGGCCTAATCT -> TGCCCAAAGGCCTAATCTC
TTGCCCAGGGATCAGCGCC -> TGCCCAGGGATCAGCGCCG
TTGCGCCATGACAACAGTA -> TGCGCCATGACAACAGTAC
TTGCGGGACCTTCGGTGTG -> TGCGGGACCTTCGGTGTGT
TTGCGGTGGGCGTTCCGAA -> TGCGGTGGGCGTTCCGAAT
TTGCGGTTCATCCGGTGGG -> TGCGGTTCATCCGGTGGGC
TTGGATGCGTTTGTACGTA -> TGGATGCGTTTGTACGTAG
TTGGCGCCAACAATGCCTG -> TGGCGCCAACAATGCCTGT
TTGGGCTTACGAGTGACGT -> TGGGCTTACGAGTGACGTC
TTGGGGTAGGCACGTGGGT -> TGGGGTAGGCACGTGGGTT
TTGGTTTTTGTGCCGTCTG -> TGGTTTTTGTGCCGTCTGG
TTGTACGTAGAACTGCTGC -> TGTACGTAGAACTGCTGCA
TTGTACGTCGGTACGTAAT -> TGTACGTCGGTACGTAATC
TTGTACTAATATTCAAGAA -> TGTACTAATATTCAAGAAA
TTGTATCATGCCGGGAGTT -> TGTATCATGCCGGGAGTTG
TTGTATGATCTCGCCTATC -> TGTATGATCTCGCCTATCC
TTGTCGGTGGGCGTTCCGA -> TGTCGGTGGGCGTTCCGAA
TTGTGCCGTCTGGATAGGG -> TGTGCCGTCTGGATAGGGC
TTGTTATACGAGCCTCGTG -> TGTTATACGAGCCTCGTGT
TTGTTGACAATTTCATCAT -> TGTTGACAATTTCATCATC
TTTAAAAGGACTTTCAGAT -> TTAAAAGGACTTTCAGATT
TTTAATCTGGATCTACTCC -> TTAATCTGGATCTACTCCC
TTTACCGCGGGAGAATTAT -> TTACCGCGGGAGAATTATC
TTTACTCAGATTGCGGTGG -> TTACTCAGATTGCGGTGGG
TTTAGGCAATGCTAAGCAC -> TTAGGCAATGCTAAGCACG
TTTAGTGGGTTGCAGTCTA -> TTAGTGGGTTGCAGTCTAA
TTTAGTTAATACTAGCCTG -> TTAGTTAATACTAGCCTGG
TTTATACTCACCGGGTGAC -> TTATACTCACCGGGTGACT
TTTATTCGGGGAATACATT -> TTATTCGGGGAATACATTC
TTTCAGATTAAGCGGGTAG -> TTCAGATTAAGCGGGTAGG
TTTCAGGGAGTACTCACAT -> TTCAGGGAGTACTCACATG
TTTCATCATCGTGGCGTAG -> TTCATCATCGTGGCGTAGC
TTTCCTAACTCCTTGTACT -> TTCCTAACTCCTTGTACTA
TTTCGAGAGATCGCGCTAG -> TTCGAGAGATCGCGCTAGC
TTTCGCATTCGAATGGCCA -> TTCGCATTCGAATGGCCAA
TTTCGCTCGTGCCTGGCTT -> TTCGCTCGTGCCTGGCTTC
TTTCGTTGCCCAGGGATCA -> TTCGTTGCCCAGGGATCAG
TTTCTCAACGACCATTTCG -> TTCTCAACGACCATTTCGC
TTTGAAGGGCGGTCCGGTG -> TTGAAGGGCGGTCCGGTGT
TTTGCAATGTTACGGGTAC -> TTGCAATGTTACGGGTACA
TTTGCGCCATGACAACAGT -> TTGCGCCATGACAACAGTA
TTTGGGGTAGGCACGTGGG -> TTGGGGTAGGCACGTGGGT
TTTGGTTTTTGTGCCGTCT -> TTGGTTTTTGTGCCGTCTG
TTTGTACGTAGAACTGCTG -> TTGTACGTAGAACTGCTGC
TTTGTACGTCGGTACGTAA -> TTGTACGTCGGTACGTAAT
TTTGTGCCGTCTGGATAGG -> TTGTGCCGTCTGGATAGGG
TTTTACTCAGATTGCGGTG -> TTTACTCAGATTGCGGTGG
TTTTCCTAACTCCTTGTAC -> TTTCCTAACTCCTTGTACT
TTTTCGTTGCCCAGGGATC -> TTTCGTTGCCCAGGGATCA
TTTTCTCAACGACCATTTC -> TTTCTCAACGACCATTTCG
TTTTGTACGTCGGTACGTA -> TTTGTACGTCGGTACGTAA
TTTTGTGCCGTCTGGATAG -> TTTGTGCCGTCTGGATAGG
TTTTTGTGCCGTCTGGATA -> TTTTGTGCCGTCTGGATAG