AAAAACCCCAT -> AAAACCCCATC
AAAAAGACCCT -> AAAAGACCCTA
AAAACAGCGAT -> AAACAGCGATG
AAAACCCCATC -> AAACCCCATCG
AAAAGACCCTA -> AAAGACCCTAA
AAAATCATTAA -> AAATCATTAAT
AAAATTGGGAG -> AAATTGGGAGG
AAACACCAGGT -> AACACCAGGTC
AAACAGCGATG -> AACAGCGATGA
AAACAGTCATA -> AACAGTCATAG
AAACCCCATCG -> AACCCCATCGC
AAACCTAAGAC -> AACCTAAGACG
AAACGACATGA -> AACGACATGAA
AAACGCGTCAG -> AACGCGTCAGA
AAACTCGCGTA -> AACTCGCGTAT
AAAGACATTCT -> AAGACATTCTC
AAAGACCCTAA -> AAGACCCTAAA
AAAGACGGTAT -> AAGACGGTATA
AAAGCTAAGCT -> AAGCTAAGCTT
AAAGGGATTTG -> AAGGGATTTGT
AAAGTCATTCC -> AAGTCATTCCA
AAAGTCCCATA -> AAGTCCCATAA
AAAGTGTTGGA -> AAGTGTTGGAC
AAAGTTAGCTT -> AAGTTAGCTTG
AAAGTTATAGG -> AAGTTATAGGG
AAAGTTCCACT -> AAGTTCCACTA
AAAGTTTTACC -> AAGTTTTACCT
AAATAGACTAC -> AATAGACTACC
AAATATCCCAA -> AATATCCCAAC
AAATATTTCAA -> AATATTTCAAA
AAATCATTAAT -> AATCATTAATT
AAATCGATCTT -> AATCGATCTTC
AAATGCCGAGG -> AATGCCGAGGG
AAATTCTACTT -> AATTCTACTTA
AAATTGGGAGG -> AATTGGGAGGT
AACAACATGGT -> ACAACATGGTA
AACAAGCAGAG -> ACAAGCAGAGA
AACACCAGGTC -> ACACCAGGTCC
AACACTTATGG -> ACACTTATGGC
AACAGCGATGA -> ACAGCGATGAC
AACAGCTCCTA -> ACAGCTCCTAT
AACAGTCATAG -> ACAGTCATAGA
AACATAGTGCA -> ACATAGTGCAG
AACATGGTAGT -> ACATGGTAGTG
AACCACCCCAG -> ACCACCCCAGT
AACCATAACCG -> ACCATAACCGT
AACCCCATCGC -> ACCCCATCGCT
AACCCGTGCGT -> ACCCGTGCGTA
AACCGAAGTGT -> ACCGAAGTGTA
AACCGTGATTT -> ACCGTGATTTA
AACCTAAGACG -> ACCTAAGACGT
AACGAAGTTGC -> ACGAAGTTGCA
AACGACATGAA -> ACGACATGAAA
AACGACGTACA -> ACGACGTACAA
AACGAGAAAAA -> ACGAGAAAAAC
AACGATGGTCC -> ACGATGGTCCA
AACGCATATGG -> ACGCATATGGC
AACGCATTCTG -> ACGCATTCTGA
AACGCCATGAT -> ACGCCATGATT
AACGCGTCAGA -> ACGCGTCAGAG
AACGCGTGCCT -> ACGCGTGCCTA
AACGGCCGCAA -> ACGGCCGCAAG
AACGGGTTCCG -> ACGGGTTCCGT
AACGTCATCGT -> ACGTCATCGTA
AACGTCGCCTT -> ACGTCGCCTTA
AACGTGTCGGT -> ACGTGTCGGTT
AACTACATGCC -> ACTACATGCCT
AACTATGGGCA -> ACTATGGGCAT
AACTCACGAAC -> ACTCACGAACA
AACTCCCATGG -> ACTCCCATGGT
AACTCGCGTAT -> ACTCGCGTATG
AACTGGCTTTA -> ACTGGCTTTAG
AACTGTGAATA -> ACTGTGAATAT
AAGACATTCTC -> AGACATTCTCA
AAGACCCTAAA -> AGACCCTAAAC
AAGACGGTATA -> AGACGGTATAC
AAGACGTACAC -> AGACGTACACT
AAGAGGTTCTT -> AGAGGTTCTTA
AAGATCTTATC -> AGATCTTATCT
AAGATTATAAC -> AGATTATAACG
AAGCAAACACC -> AGCAAACACCA
AAGCAGAGAAT -> AGCAGAGAATG
AAGCCGGGTAA -> AGCCGGGTAAT
AAGCGACATGT -> AGCGACATGTG
AAGCGCTGAAG -> AGCGCTGAAGC
AAGCGGGGTTC -> AGCGGGGTTCC
AAGCTAAGCTT -> AGCTAAGCTTT
AAGCTCATTTC -> AGCTCATTTCC
AAGCTTTACCT -> AGCTTTACCTT
AAGGAAATCGA -> AGGAAATCGAT
AAGGCACTTAC -> AGGCACTTACT
AAGGCCTGTTA -> AGGCCTGTTAG
AAGGCTCCGAG -> AGGCTCCGAGG
AAGGGATTTGT -> AGGGATTTGTC
AAGGTTGGATC -> AGGTTGGATCT
AAGTCATCGCG -> AGTCATCGCGA
AAGTCATTCCA -> AGTCATTCCAG
AAGTCCCATAA -> AGTCCCATAAA
AAGTGTATGAT -> AGTGTATGATC
AAGTGTTGGAC -> AGTGTTGGACA
AAGTTAGCTTG -> AGTTAGCTTGC
AAGTTATAGGG -> AGTTATAGGGG
AAGTTCCACTA -> AGTTCCACTAC
AAGTTCTCCAA -> AGTTCTCCAAC
AAGTTGCAACG -> AGTTGCAACGT
AAGTTTTACCT -> AGTTTTACCTG
AATACTTGTGA -> ATACTTGTGAC
AATAGACTACC -> ATAGACTACCG
AATATCCCAAC -> ATATCCCAACG
AATATTCCGGG -> ATATTCCGGGG
AATATTTCAAA -> ATATTTCAAAA
AATCACGCAGT -> ATCACGCAGTT
AATCACGTCAT -> ATCACGTCATG
AATCATTAATT -> ATCATTAATTC
AATCCCGTTAG -> ATCCCGTTAGC
AATCCGCTGGC -> ATCCGCTGGCT
AATCGATCTTC -> ATCGATCTTCA
AATCTAATGAA -> ATCTAATGAAG
AATCTGAGCTA -> ATCTGAGCTAA
AATCTGCCTGT -> ATCTGCCTGTC
AATGAAGCTCA -> ATGAAGCTCAT
AATGACGCAAC -> ATGACGCAACC
AATGCCGAGGG -> ATGCCGAGGGC
AATGCTCTCGG -> ATGCTCTCGGT
AATGTTCACCG -> ATGTTCACCGC
AATGTTGAACT -> ATGTTGAACTG
AATGTTTATGC -> ATGTTTATGCT
AATTAGGTACT -> ATTAGGTACTC
AATTCGTCATT -> ATTCGTCATTT
AATTCTACTTA -> ATTCTACTTAC
AATTGGGAGGT -> ATTGGGAGGTC
AATTTTTCTAC -> ATTTTTCTACG
ACAAAGTCATT -> CAAAGTCATTC
ACAACATGGTA -> CAACATGGTAG
ACAACGTCATC -> CAACGTCATCG
ACAAGCAGAGA -> CAAGCAGAGAA
ACAATCTGCCT -> CAATCTGCCTG
ACAATGTTGAA -> CAATGTTGAAC
ACACACCAAAC -> CACACCAAACG
ACACCAAACGC -> CACCAAACGCG
ACACCAGGTCC -> CACCAGGTCCA
ACACCGACTAC -> CACCGACTACG
ACACGAAGGTT -> CACGAAGGTTG
ACACTCATAAA -> CACTCATAAAC
ACACTTATGGC -> CACTTATGGCT
ACACTTATTTC -> CACTTATTTCC
ACAGAGTCTTC -> CAGAGTCTTCT
ACAGCGATGAC -> CAGCGATGACG
ACAGCGTCTCG -> CAGCGTCTCGA
ACAGCTCCTAT -> CAGCTCCTATA
ACAGGTTCTGG -> CAGGTTCTGGC
ACAGTCATAGA -> CAGTCATAGAA
ACATACTCGGA -> CATACTCGGAC
ACATAGTGCAG -> CATAGTGCAGA
ACATCTCGTGG -> CATCTCGTGGC
ACATGAAATGC -> CATGAAATGCC
ACATGAACCGA -> CATGAACCGAA
ACATGCCTTAA -> CATGCCTTAAT
ACATGGTAGTG -> CATGGTAGTGA
ACATGTGTACC -> CATGTGTACCG
ACATGTTTAAC -> CATGTTTAACT
ACATTCTCAAC -> CATTCTCAACG
ACATTGGTAGA -> CATTGGTAGAT
ACATTTGCCGA -> CATTTGCCGAG
ACCAAACGCGT -> CCAAACGCGTC
ACCAAAGGGAT -> CCAAAGGGATT
ACCACCCCAGT -> CCACCCCAGTA
ACCACGGTGGG -> CCACGGTGGGG
ACCACTACCGA -> CCACTACCGAG
ACCAGGTCCAT -> CCAGGTCCATG
ACCATAACCGT -> CCATAACCGTG
ACCATTCAACG -> CCATTCAACGC
ACCCCAGTACG -> CCCCAGTACGG
ACCCCATCGCT -> CCCCATCGCTA
ACCCGGACTCA -> CCCGGACTCAT
ACCCGTGCGTA -> CCCGTGCGTAC
ACCCTAAACTC -> CCCTAAACTCG
ACCCTCGTCAT -> CCCTCGTCATC
ACCGAAGTGTA -> CCGAAGTGTAT
ACCGACTACGG -> CCGACTACGGT
ACCGAGGCCTA -> CCGAGGCCTAA
ACCGCAAGGCA -> CCGCAAGGCAC
ACCGCCTTAAC -> CCGCCTTAACG
ACCGCTAGGGG -> CCGCTAGGGGG
ACCGCTTTGGC -> CCGCTTTGGCT
ACCGGCGAAGC -> CCGGCGAAGCG
ACCGTAACCAT -> CCGTAACCATA
ACCGTGATTTA -> CCGTGATTTAA
ACCTAAGACGT -> CCTAAGACGTA
ACCTCGTGTAG -> CCTCGTGTAGT
ACCTGCTCTAC -> CCTGCTCTACA
ACCTTATGTTA -> CCTTATGTTAC
ACCTTCTTGTT -> CCTTCTTGTTA
ACGAAAATTGG -> CGAAAATTGGG
ACGAACATAGT -> CGAACATAGTG
ACGAAGGTTGG -> CGAAGGTTGGA
ACGAAGTTCTC -> CGAAGTTCTCC
ACGAAGTTGCA -> CGAAGTTGCAA
ACGAATGCTCT -> CGAATGCTCTC
ACGACATGAAA -> CGACATGAAAT
ACGACCCTCGT -> CGACCCTCGTC
ACGACGTACAA -> CGACGTACAAT
ACGACTAGGTC -> CGACTAGGTCT
ACGAGAAAAAC -> CGAGAAAAACC
ACGATGGTCCA -> CGATGGTCCAA
ACGATTGCTAA -> CGATTGCTAAC
ACGCAACCCGT -> CGCAACCCGTG
ACGCAGCAAGA -> CGCAGCAAGAG
ACGCAGTTATT -> CGCAGTTATTT
ACGCATATGGC -> CGCATATGGCT
ACGCATTCTGA -> CGCATTCTGAT
ACGCATTGAAC -> CGCATTGAACG
ACGCATTGACC -> CGCATTGACCA
ACGCCAGTCCT -> CGCCAGTCCTG
ACGCCATGATT -> CGCCATGATTT
ACGCGATTATT -> CGCGATTATTA
ACGCGTCAGAG -> CGCGTCAGAGA
ACGCGTGCCTA -> CGCGTGCCTAC
ACGGCAGGCTG -> CGGCAGGCTGA
ACGGCATCGCT -> CGGCATCGCTG
ACGGCCGCAAG -> CGGCCGCAAGA
ACGGGTAGAGT -> CGGGTAGAGTT
ACGGGTTCCGT -> CGGGTTCCGTA
ACGGTACGCCA -> CGGTACGCCAG
ACGGTATACAA -> CGGTATACAAC
ACGGTGGGGTC -> CGGTGGGGTCT
ACGTAATCACG -> CGTAATCACGT
ACGTACAATCT -> CGTACAATCTG
ACGTACACTTA -> CGTACACTTAT
ACGTCATCGTA -> CGTCATCGTAA
ACGTCATGATA -> CGTCATGATAG
ACGTCGATTTA -> CGTCGATTTAC
ACGTCGCCTTA -> CGTCGCCTTAT
ACGTGTCGGTT -> CGTGTCGGTTG
ACTACAGGTTC -> CTACAGGTTCT
ACTACATGCCT -> CTACATGCCTT
ACTACCGAGGC -> CTACCGAGGCC
ACTACCGCAAG -> CTACCGCAAGG
ACTACGGCAGG -> CTACGGCAGGC
ACTACGGTACG -> CTACGGTACGC
ACTAGGGGGAG -> CTAGGGGGAGG
ACTAGGTCTGT -> CTAGGTCTGTT
ACTATAGCTTA -> CTATAGCTTAC
ACTATGGGCAT -> CTATGGGCATT
ACTCAAATTCT -> CTCAAATTCTA
ACTCACGAACA -> CTCACGAACAT
ACTCATAAACA -> CTCATAAACAG
ACTCATCGTTG -> CTCATCGTTGC
ACTCCCATGGT -> CTCCCATGGTC
ACTCGAACGCC -> CTCGAACGCCA
ACTCGCGTATG -> CTCGCGTATGA
ACTCGGACATG -> CTCGGACATGT
ACTCTCCCCCG -> CTCTCCCCCGT
ACTGACACGAA -> CTGACACGAAG
ACTGATTTGTA -> CTGATTTGTAT
ACTGGCTTTAG -> CTGGCTTTAGA
ACTGGTTGTCG -> CTGGTTGTCGA
ACTGTGAATAT -> CTGTGAATATT
ACTTACTATAG -> CTTACTATAGC
ACTTACTTCAC -> CTTACTTCACC
ACTTATGGCTG -> CTTATGGCTGG
ACTTATTTCCC -> CTTATTTCCCT
ACTTCACCCGG -> CTTCACCCGGA
ACTTGTGACGA -> CTTGTGACGAC
AGAAAAACCCC -> GAAAAACCCCA
AGAAAGACATT -> GAAAGACATTC
AGAAAGTTTTA -> GAAAGTTTTAC
AGAATGACGCA -> GAATGACGCAA
AGACATACTCG -> GACATACTCGG
AGACATTCTCA -> GACATTCTCAA
AGACCAAAGGG -> GACCAAAGGGA
AGACCACGGTG -> GACCACGGTGG
AGACCCTAAAC -> GACCCTAAACT
AGACGGTATAC -> GACGGTATACA
AGACGTACACT -> GACGTACACTT
AGACTACCGCA -> GACTACCGCAA
AGACTAGGGGG -> GACTAGGGGGA
AGACTCTCCCC -> GACTCTCCCCC
AGAGAAAGACA -> GAGAAAGACAT
AGAGAATGACG -> GAGAATGACGC
AGAGAGCATCA -> GAGAGCATCAC
AGAGCATCACG -> GAGCATCACGC
AGAGGTTCGCT -> GAGGTTCGCTC
AGAGGTTCTTA -> GAGGTTCTTAA
AGAGTCTTCTG -> GAGTCTTCTGT
AGAGTTACGAT -> GAGTTACGATT
AGAGTTTATAA -> GAGTTTATAAC
AGATCCCTGCT -> GATCCCTGCTT
AGATCTTATCT -> GATCTTATCTG
AGATGAATGTT -> GATGAATGTTC
AGATTATAACG -> GATTATAACGT
AGCAAACACCA -> GCAAACACCAG
AGCAAGAGGTT -> GCAAGAGGTTC
AGCACAAAGTC -> GCACAAAGTCA
AGCACTCGAAC -> GCACTCGAACG
AGCAGAGAATG -> GCAGAGAATGA
AGCATACACCG -> GCATACACCGA
AGCATCACGCA -> GCATCACGCAT
AGCCGGGTAAT -> GCCGGGTAATC
AGCGACATGTG -> GCGACATGTGT
AGCGATGACGA -> GCGATGACGAA
AGCGCAGTCCG -> GCGCAGTCCGT
AGCGCTGAAGC -> GCGCTGAAGCG
AGCGGGGTTCC -> GCGGGGTTCCA
AGCGTCTCGAG -> GCGTCTCGAGC
AGCTAAGCTTT -> GCTAAGCTTTA
AGCTAATGTTT -> GCTAATGTTTA
AGCTCATTTCC -> GCTCATTTCCA
AGCTCCTATAG -> GCTCCTATAGG
AGCTTACGCGA -> GCTTACGCGAT
AGCTTGCCGCC -> GCTTGCCGCCA
AGCTTTACCTT -> GCTTTACCTTC
AGGAAATCGAT -> GGAAATCGATC
AGGACCGCTTT -> GGACCGCTTTG
AGGACGAATGC -> GGACGAATGCT
AGGAGAGAAAG -> GGAGAGAAAGA
AGGCACTTACT -> GGCACTTACTA
AGGCCTAATCC -> GGCCTAATCCG
AGGCCTGTTAG -> GGCCTGTTAGA
AGGCTCCGAGG -> GGCTCCGAGGG
AGGCTGAGTAT -> GGCTGAGTATG
AGGCTGGGCGG -> GGCTGGGCGGA
AGGGATTTGTC -> GGGATTTGTCT
AGGGCCCTGAC -> GGGCCCTGACA
AGGGCTCGGCT -> GGGCTCGGCTC
AGGGGAAAGTG -> GGGGAAAGTGT
AGGGGAATCTA -> GGGGAATCTAA
AGGGGGAGGGG -> GGGGGAGGGGA
AGGGGGTTTCC -> GGGGGTTTCCG
AGGTAAAGTTA -> GGTAAAGTTAT
AGGTAAGGCTC -> GGTAAGGCTCC
AGGTACTCAAA -> GGTACTCAAAT
AGGTCCATCAA -> GGTCCATCAAC
AGGTCCATGAA -> GGTCCATGAAA
AGGTCCCGGAG -> GGTCCCGGAGG
AGGTCTGTTTA -> GGTCTGTTTAG
AGGTGAATCTG -> GGTGAATCTGA
AGGTTCGCTCA -> GGTTCGCTCAG
AGGTTCTGGCC -> GGTTCTGGCCC
AGGTTCTTAAC -> GGTTCTTAACT
AGGTTGGATCT -> GGTTGGATCTC
AGGTTTAACTG -> GGTTTAACTGG
AGTACGGCATC -> GTACGGCATCG
AGTATCCACCG -> GTATCCACCGG
AGTATGACTGA -> GTATGACTGAT
AGTCATAGAAA -> GTCATAGAAAG
AGTCATCGCGA -> GTCATCGCGAC
AGTCATTCCAG -> GTCATTCCAGT
AGTCCCATAAA -> GTCCCATAAAA
AGTCCGTGGTG -> GTCCGTGGTGG
AGTCCTGTGTG -> GTCCTGTGTGC
AGTCGGGTTAA -> GTCGGGTTAAT
AGTCTGACGGG -> GTCTGACGGGT
AGTCTTCTGTC -> GTCTTCTGTCG
AGTGAAGCAAA -> GTGAAGCAAAC
AGTGATAAATA -> GTGATAAATAG
AGTGCAGAGGT -> GTGCAGAGGTT
AGTGGTTGAAC -> GTGGTTGAACA
AGTGTATGATC -> GTGTATGATCT
AGTGTCCATAA -> GTGTCCATAAT
AGTGTTGGACA -> GTGTTGGACAG
AGTTAAATATC -> GTTAAATATCC
AGTTACGATTG -> GTTACGATTGC
AGTTAGCTTGC -> GTTAGCTTGCC
AGTTATAGGGG -> GTTATAGGGGA
AGTTATTTTGT -> GTTATTTTGTG
AGTTCACGCAT -> GTTCACGCATT
AGTTCCACTAC -> GTTCCACTACG
AGTTCTCCAAC -> GTTCTCCAACG
AGTTGCAACGT -> GTTGCAACGTC
AGTTTATAACG -> GTTTATAACGC
AGTTTCTAAAG -> GTTTCTAAAGC
AGTTTTAAGGC -> GTTTTAAGGCC
AGTTTTACCTG -> GTTTTACCTGC
ATAAACAGTCA -> TAAACAGTCAT
ATAAATAGACT -> TAAATAGACTA
ATAACCGTGAT -> TAACCGTGATT
ATAACGCATTC -> TAACGCATTCT
ATAACGTGTCG -> TAACGTGTCGG
ATAAGGAAATC -> TAAGGAAATCG
ATAATCACGCA -> TAATCACGCAG
ATACAACGTCA -> TACAACGTCAT
ATACACCGACT -> TACACCGACTA
ATACTCGGACA -> TACTCGGACAT
ATACTTGTGAC -> TACTTGTGACG
ATAGAAAGTTT -> TAGAAAGTTTT
ATAGACTACCG -> TAGACTACCGC
ATAGCTTACGC -> TAGCTTACGCG
ATAGGACGAAT -> TAGGACGAATG
ATAGGGGAAAG -> TAGGGGAAAGT
ATAGGTCCCGG -> TAGGTCCCGGA
ATAGTCTGACG -> TAGTCTGACGG
ATAGTGCAGAG -> TAGTGCAGAGG
ATATATCCTAG -> TATATCCTAGT
ATATCCCAACG -> TATCCCAACGG
ATATCCTAGTT -> TATCCTAGTTT
ATATGGCTATG -> TATGGCTATGT
ATATTCCGGGG -> TATTCCGGGGC
ATATTTCAAAA -> TATTTCAAAAA
ATCAAAGTTCC -> TCAAAGTTCCA
ATCAACAAGCA -> TCAACAAGCAG
ATCACCACTAC -> TCACCACTACC
ATCACGCAGTT -> TCACGCAGTTA
ATCACGCATTG -> TCACGCATTGA
ATCACGTCATG -> TCACGTCATGA
ATCATTAATTC -> TCATTAATTCG
ATCCACCGGCG -> TCCACCGGCGA
ATCCCAACGGC -> TCCCAACGGCC
ATCCCCCCGCG -> TCCCCCCGCGT
ATCCCGTTAGC -> TCCCGTTAGCG
ATCCCTGCTTA -> TCCCTGCTTAT
ATCCGCTGGCT -> TCCGCTGGCTC
ATCCTAGTTTT -> TCCTAGTTTTA
ATCCTATATAT -> TCCTATATATC
ATCGAGAGTTT -> TCGAGAGTTTA
ATCGATCTTCA -> TCGATCTTCAA
ATCGCGACACA -> TCGCGACACAC
ATCGCTATTGC -> TCGCTATTGCG
ATCGCTGGACA -> TCGCTGGACAC
ATCGGGTTCCG -> TCGGGTTCCGG
ATCGTAAAGTT -> TCGTAAAGTTA
ATCGTTGCTTG -> TCGTTGCTTGG
ATCTAATGAAG -> TCTAATGAAGC
ATCTCGTGGCA -> TCTCGTGGCAA
ATCTCTGCCGC -> TCTCTGCCGCG
ATCTCTTACAG -> TCTCTTACAGA
ATCTGAGCTAA -> TCTGAGCTAAT
ATCTGCCTGTC -> TCTGCCTGTCG
ATCTGCGGGTC -> TCTGCGGGTCG
ATCTGGCGAGA -> TCTGGCGAGAT
ATCTGTCATTC -> TCTGTCATTCT
ATCTTATCTGT -> TCTTATCTGTC
ATCTTCAAGTC -> TCTTCAAGTCA
ATGAAAACAGC -> TGAAAACAGCG
ATGAAATGCCG -> TGAAATGCCGA
ATGAACCGAAG -> TGAACCGAAGT
ATGAAGCTCAT -> TGAAGCTCATT
ATGAATGTTCA -> TGAATGTTCAC
ATGACGAAAAT -> TGACGAAAATT
ATGACGCAACC -> TGACGCAACCC
ATGACTGATTT -> TGACTGATTTG
ATGATAGGTCC -> TGATAGGTCCC
ATGATCTGGCG -> TGATCTGGCGA
ATGATTAGGTA -> TGATTAGGTAA
ATGATTTGTGC -> TGATTTGTGCT
ATGCCGAGGGC -> TGCCGAGGGCC
ATGCCTTAATA -> TGCCTTAATAC
ATGCGCGTCAA -> TGCGCGTCAAA
ATGCTCCGACG -> TGCTCCGACGA
ATGCTCTCGGT -> TGCTCTCGGTA
ATGGCTATGTC -> TGGCTATGTCG
ATGGCTGGCCA -> TGGCTGGCCAA
ATGGGCATTCA -> TGGGCATTCAA
ATGGTAGTGAA -> TGGTAGTGAAG
ATGGTCAACGA -> TGGTCAACGAT
ATGGTCCAAAC -> TGGTCCAAACG
ATGTCGCCCAA -> TGTCGCCCAAA
ATGTGCTGGAT -> TGTGCTGGATA
ATGTGTACCGT -> TGTGTACCGTA
ATGTTACTGAC -> TGTTACTGACA
ATGTTCACCGC -> TGTTCACCGCT
ATGTTGAACTG -> TGTTGAACTGT
ATGTTTAACTC -> TGTTTAACTCC
ATGTTTATGCT -> TGTTTATGCTC
ATTAATTCGTC -> TTAATTCGTCA
ATTACATTTGC -> TTACATTTGCC
ATTAGGTAAGG -> TTAGGTAAGGC
ATTAGGTACTC -> TTAGGTACTCA
ATTATAACGTG -> TTATAACGTGT
ATTATTACATT -> TTATTACATTT
ATTCAAAGACG -> TTCAAAGACGG
ATTCAACGCAT -> TTCAACGCATA
ATTCCAGTTCA -> TTCCAGTTCAC
ATTCCGGGGCC -> TTCCGGGGCCT
ATTCGTCATTT -> TTCGTCATTTA
ATTCTACTTAC -> TTCTACTTACT
ATTCTCAACGA -> TTCTCAACGAA
ATTCTGATTGG -> TTCTGATTGGG
ATTCTTTTAGA -> TTCTTTTAGAC
ATTGAACGGGT -> TTGAACGGGTT
ATTGACCATTC -> TTGACCATTCA
ATTGCATCGAG -> TTGCATCGAGA
ATTGCGCGCTG -> TTGCGCGCTGC
ATTGCTAACCA -> TTGCTAACCAC
ATTGGGAGGTC -> TTGGGAGGTCC
ATTGGGGGGAA -> TTGGGGGGAAC
ATTGGTAGATC -> TTGGTAGATCC
ATTTAAGCGCT -> TTTAAGCGCTG
ATTTACATTGG -> TTTACATTGGT
ATTTAGTGATA -> TTTAGTGATAA
ATTTCAAAAAG -> TTTCAAAAAGA
ATTTCCATAAG -> TTTCCATAAGG
ATTTCCCTGAG -> TTTCCCTGAGT
ATTTGCCGAGC -> TTTGCCGAGCA
ATTTGTATCCT -> TTTGTATCCTA
ATTTGTCTTCC -> TTTGTCTTCCA
ATTTGTGCTGT -> TTTGTGCTGTG
ATTTTGTGTGT -> TTTTGTGTGTC
ATTTTTCTACG -> TTTTTCTACGT
CAAAAAGACCC -> AAAAAGACCCT
CAAAATCATTA -> AAAATCATTAA
CAAACACCAGG -> AAACACCAGGT
CAAACGACATG -> AAACGACATGA
CAAACGCGTCA -> AAACGCGTCAG
CAAAGACGGTA -> AAAGACGGTAT
CAAAGGGATTT -> AAAGGGATTTG
CAAAGTCATTC -> AAAGTCATTCC
CAAAGTCCCAT -> AAAGTCCCATA
CAAAGTTCCAC -> AAAGTTCCACT
CAAATATTTCA -> AAATATTTCAA
CAAATTCTACT -> AAATTCTACTT
CAACAAGCAGA -> AACAAGCAGAG
CAACATGGTAG -> AACATGGTAGT
CAACCCGTGCG -> AACCCGTGCGT
CAACGAAGTTG -> AACGAAGTTGC
CAACGACGTAC -> AACGACGTACA
CAACGATGGTC -> AACGATGGTCC
CAACGCATATG -> AACGCATATGG
CAACGCGTGCC -> AACGCGTGCCT
CAACGGCCGCA -> AACGGCCGCAA
CAACGTCATCG -> AACGTCATCGT
CAACGTCGCCT -> AACGTCGCCTT
CAAGAGGTTCT -> AAGAGGTTCTT
CAAGATTATAA -> AAGATTATAAC
CAAGCAGAGAA -> AAGCAGAGAAT
CAAGCCGGGTA -> AAGCCGGGTAA
CAAGGCACTTA -> AAGGCACTTAC
CAAGTCATCGC -> AAGTCATCGCG
CAATCTGCCTG -> AATCTGCCTGT
CAATGTTGAAC -> AATGTTGAACT
CACAAAGTCAT -> ACAAAGTCATT
CACACCAAACG -> ACACCAAACGC
CACCAAACGCG -> ACCAAACGCGT
CACCACTACCG -> ACCACTACCGA
CACCAGGTCCA -> ACCAGGTCCAT
CACCCCAGTAC -> ACCCCAGTACG
CACCCGGACTC -> ACCCGGACTCA
CACCGACTACG -> ACCGACTACGG
CACCGCTAGGG -> ACCGCTAGGGG
CACCGGCGAAG -> ACCGGCGAAGC
CACCTCGTGTA -> ACCTCGTGTAG
CACGAACATAG -> ACGAACATAGT
CACGAAGGTTG -> ACGAAGGTTGG
CACGCAGTTAT -> ACGCAGTTATT
CACGCATTGAA -> ACGCATTGAAC
CACGCATTGAC -> ACGCATTGACC
CACGGTGGGGT -> ACGGTGGGGTC
CACGTAATCAC -> ACGTAATCACG
CACGTCATGAT -> ACGTCATGATA
CACTACCGAGG -> ACTACCGAGGC
CACTACGGCAG -> ACTACGGCAGG
CACTCATAAAC -> ACTCATAAACA
CACTCGAACGC -> ACTCGAACGCC
CACTTACTATA -> ACTTACTATAG
CACTTATGGCT -> ACTTATGGCTG
CACTTATTTCC -> ACTTATTTCCC
CAGAGAATGAC -> AGAGAATGACG
CAGAGAGCATC -> AGAGAGCATCA
CAGAGGTTCGC -> AGAGGTTCGCT
CAGAGTCTTCT -> AGAGTCTTCTG
CAGCAAGAGGT -> AGCAAGAGGTT
CAGCGATGACG -> AGCGATGACGA
CAGCGTCTCGA -> AGCGTCTCGAG
CAGCTCCTATA -> AGCTCCTATAG
CAGGACCGCTT -> AGGACCGCTTT
CAGGAGAGAAA -> AGGAGAGAAAG
CAGGCTGAGTA -> AGGCTGAGTAT
CAGGTCCATGA -> AGGTCCATGAA
CAGGTTCTGGC -> AGGTTCTGGCC
CAGGTTTAACT -> AGGTTTAACTG
CAGTACGGCAT -> AGTACGGCATC
CAGTCATAGAA -> AGTCATAGAAA
CAGTCCGTGGT -> AGTCCGTGGTG
CAGTCCTGTGT -> AGTCCTGTGTG
CAGTGTCCATA -> AGTGTCCATAA
CAGTTAAATAT -> AGTTAAATATC
CAGTTATTTTG -> AGTTATTTTGT
CAGTTCACGCA -> AGTTCACGCAT
CATAAACAGTC -> ATAAACAGTCA
CATAACCGTGA -> ATAACCGTGAT
CATAAGGAAAT -> ATAAGGAAATC
CATAATCACGC -> ATAATCACGCA
CATACACCGAC -> ATACACCGACT
CATACTCGGAC -> ATACTCGGACA
CATAGAAAGTT -> ATAGAAAGTTT
CATAGTGCAGA -> ATAGTGCAGAG
CATATGGCTAT -> ATATGGCTATG
CATCAACAAGC -> ATCAACAAGCA
CATCACGCATT -> ATCACGCATTG
CATCCCCCCGC -> ATCCCCCCGCG
CATCGAGAGTT -> ATCGAGAGTTT
CATCGCGACAC -> ATCGCGACACA
CATCGCTATTG -> ATCGCTATTGC
CATCGCTGGAC -> ATCGCTGGACA
CATCGGGTTCC -> ATCGGGTTCCG
CATCGTAAAGT -> ATCGTAAAGTT
CATCGTTGCTT -> ATCGTTGCTTG
CATCTCGTGGC -> ATCTCGTGGCA
CATGAAAACAG -> ATGAAAACAGC
CATGAAATGCC -> ATGAAATGCCG
CATGAACCGAA -> ATGAACCGAAG
CATGATAGGTC -> ATGATAGGTCC
CATGATTTGTG -> ATGATTTGTGC
CATGCCTTAAT -> ATGCCTTAATA
CATGGTAGTGA -> ATGGTAGTGAA
CATGGTCAACG -> ATGGTCAACGA
CATGTGTACCG -> ATGTGTACCGT
CATGTTTAACT -> ATGTTTAACTC
CATTAATTCGT -> ATTAATTCGTC
CATTCAAAGAC -> ATTCAAAGACG
CATTCAACGCA -> ATTCAACGCAT
CATTCCAGTTC -> ATTCCAGTTCA
CATTCTCAACG -> ATTCTCAACGA
CATTCTGATTG -> ATTCTGATTGG
CATTCTTTTAG -> ATTCTTTTAGA
CATTGAACGGG -> ATTGAACGGGT
CATTGACCATT -> ATTGACCATTC
CATTGGTAGAT -> ATTGGTAGATC
CATTTAGTGAT -> ATTTAGTGATA
CATTTCCATAA -> ATTTCCATAAG
CATTTGCCGAG -> ATTTGCCGAGC
CCAAAATCATT -> CAAAATCATTA
CCAAACGACAT -> CAAACGACATG
CCAAACGCGTC -> CAAACGCGTCA
CCAAAGGGATT -> CAAAGGGATTT
CCAACGACGTA -> CAACGACGTAC
CCAACGCGTGC -> CAACGCGTGCC
CCAACGGCCGC -> CAACGGCCGCA
CCACCCCAGTA -> CACCCCAGTAC
CCACCGGCGAA -> CACCGGCGAAG
CCACCTCGTGT -> CACCTCGTGTA
CCACGGTGGGG -> CACGGTGGGGT
CCACTACCGAG -> CACTACCGAGG
CCACTACGGCA -> CACTACGGCAG
CCAGGACCGCT -> CAGGACCGCTT
CCAGGAGAGAA -> CAGGAGAGAAA
CCAGGTCCATG -> CAGGTCCATGA
CCAGGTTTAAC -> CAGGTTTAACT
CCAGTACGGCA -> CAGTACGGCAT
CCAGTCCTGTG -> CAGTCCTGTGT
CCAGTTAAATA -> CAGTTAAATAT
CCAGTTCACGC -> CAGTTCACGCA
CCATAACCGTG -> CATAACCGTGA
CCATAAGGAAA -> CATAAGGAAAT
CCATAATCACG -> CATAATCACGC
CCATCAACAAG -> CATCAACAAGC
CCATCGCTATT -> CATCGCTATTG
CCATGAAAACA -> CATGAAAACAG
CCATGATTTGT -> CATGATTTGTG
CCATGGTCAAC -> CATGGTCAACG
CCATTCAACGC -> CATTCAACGCA
CCCAAAATCAT -> CCAAAATCATT
CCCAACGGCCG -> CCAACGGCCGC
CCCACCTCGTG -> CCACCTCGTGT
CCCAGTACGGC -> CCAGTACGGCA
CCCATCGCTAT -> CCATCGCTATT
CCCATGGTCAA -> CCATGGTCAAC
CCCCAGTACGG -> CCCAGTACGGC
CCCCATCGCTA -> CCCATCGCTAT
CCCCCCGCGTC -> CCCCCGCGTCG
CCCCCGCGTCG -> CCCCGCGTCGA
CCCCCGTGGCG -> CCCCGTGGCGA
CCCCGAGACTC -> CCCGAGACTCT
CCCCGCGTCGA -> CCCGCGTCGAC
CCCCGTGGCGA -> CCCGTGGCGAT
CCCGAGACTCT -> CCGAGACTCTC
CCCGCGTCGAC -> CCGCGTCGACT
CCCGGACTCAT -> CCGGACTCATC
CCCGGAGGCTG -> CCGGAGGCTGG
CCCGTGCGTAC -> CCGTGCGTACG
CCCGTGGCGAT -> CCGTGGCGATC
CCCGTTAGCGC -> CCGTTAGCGCA
CCCTAAACTCG -> CCTAAACTCGC
CCCTCGCAAAG -> CCTCGCAAAGT
CCCTCGTCATC -> CCTCGTCATCC
CCCTGACATCT -> CCTGACATCTC
CCCTGAGTATC -> CCTGAGTATCC
CCCTGCTTATG -> CCTGCTTATGC
CCGAAGTGTAT -> CGAAGTGTATG
CCGACGAAGTT -> CGACGAAGTTC
CCGACTACGGT -> CGACTACGGTA
CCGAGACTCTC -> CGAGACTCTCC
CCGAGCATACA -> CGAGCATACAC
CCGAGGCCTAA -> CGAGGCCTAAT
CCGAGGGCCCT -> CGAGGGCCCTG
CCGAGGGCTCG -> CGAGGGCTCGG
CCGCAAGATTA -> CGCAAGATTAT
CCGCAAGGCAC -> CGCAAGGCACT
CCGCCAGGTTT -> CGCCAGGTTTA
CCGCCTTAACG -> CGCCTTAACGA
CCGCGCTACCT -> CGCGCTACCTT
CCGCGGCTGGA -> CGCGGCTGGAA
CCGCGTCGACT -> CGCGTCGACTA
CCGCTAGGGGG -> CGCTAGGGGGT
CCGCTGGCTCT -> CGCTGGCTCTG
CCGCTTTGGCT -> CGCTTTGGCTG
CCGGACTCATC -> CGGACTCATCG
CCGGAGGCTGG -> CGGAGGCTGGG
CCGGCGAAGCG -> CGGCGAAGCGA
CCGGGGCCTAG -> CGGGGCCTAGT
CCGGGTAATCC -> CGGGTAATCCC
CCGGTTACTGG -> CGGTTACTGGT
CCGTAACAGCT -> CGTAACAGCTC
CCGTAACCATA -> CGTAACCATAA
CCGTGATTTAA -> CGTGATTTAAG
CCGTGCGTACG -> CGTGCGTACGA
CCGTGGCGATC -> CGTGGCGATCT
CCGTGGTGGTG -> CGTGGTGGTGT
CCGTTAGCGCA -> CGTTAGCGCAG
CCTAAACTCGC -> CTAAACTCGCG
CCTAAGACGTA -> CTAAGACGTAC
CCTAATCCGCT -> CTAATCCGCTG
CCTACCGCCTT -> CTACCGCCTTA
CCTAGTCGGGT -> CTAGTCGGGTT
CCTAGTTTTAA -> CTAGTTTTAAG
CCTATAGGACG -> CTATAGGACGA
CCTATATATCC -> CTATATATCCT
CCTCGCAAAGT -> CTCGCAAAGTC
CCTCGTCATCC -> CTCGTCATCCC
CCTCGTGTAGT -> CTCGTGTAGTG
CCTGACATCTC -> CTGACATCTCG
CCTGAGTATCC -> CTGAGTATCCA
CCTGCTCTACA -> CTGCTCTACAT
CCTGCTTATGC -> CTGCTTATGCG
CCTGTCGACGC -> CTGTCGACGCA
CCTGTGTGCAC -> CTGTGTGCACG
CCTGTTAGACC -> CTGTTAGACCA
CCTTAACGAGA -> CTTAACGAGAA
CCTTAATACTT -> CTTAATACTTG
CCTTATCAAAG -> CTTATCAAAGT
CCTTATGTTAC -> CTTATGTTACT
CCTTCTTGTTA -> CTTCTTGTTAT
CGAAAATTGGG -> GAAAATTGGGA
CGAACATAGTG -> GAACATAGTGC
CGAACGCCATG -> GAACGCCATGA
CGAAGATCTTA -> GAAGATCTTAT
CGAAGCGACAT -> GAAGCGACATG
CGAAGGTTGGA -> GAAGGTTGGAT
CGAAGTGTATG -> GAAGTGTATGA
CGAAGTTCTCC -> GAAGTTCTCCA
CGAAGTTGCAA -> GAAGTTGCAAC
CGAATGCTCTC -> GAATGCTCTCG
CGACACACCAA -> GACACACCAAA
CGACATGAAAT -> GACATGAAATG
CGACATGTGTA -> GACATGTGTAC
CGACCCTCGTC -> GACCCTCGTCA
CGACGAAGTTC -> GACGAAGTTCT
CGACGCAGCAA -> GACGCAGCAAG
CGACGTACAAT -> GACGTACAATC
CGACTACAGGT -> GACTACAGGTT
CGACTACGGTA -> GACTACGGTAC
CGACTAGGTCT -> GACTAGGTCTG
CGAGAAAAACC -> GAGAAAAACCC
CGAGACTCTCC -> GAGACTCTCCC
CGAGAGTTTAT -> GAGAGTTTATA
CGAGATGAATG -> GAGATGAATGT
CGAGCACTCGA -> GAGCACTCGAA
CGAGCATACAC -> GAGCATACACC
CGAGGCCTAAT -> GAGGCCTAATC
CGAGGGCCCTG -> GAGGGCCCTGA
CGAGGGCTCGG -> GAGGGCTCGGC
CGAGTTTCTAA -> GAGTTTCTAAA
CGATCTCTGCC -> GATCTCTGCCG
CGATCTTCAAG -> GATCTTCAAGT
CGATGACGAAA -> GATGACGAAAA
CGATGGTCCAA -> GATGGTCCAAA
CGATTATTACA -> GATTATTACAT
CGATTGCTAAC -> GATTGCTAACC
CGATTTACATT -> GATTTACATTG
CGCAAAGTCCC -> GCAAAGTCCCA
CGCAACCCGTG -> GCAACCCGTGC
CGCAAGATTAT -> GCAAGATTATA
CGCAAGGCACT -> GCAAGGCACTT
CGCAGCAAGAG -> GCAGCAAGAGG
CGCAGTCCGTG -> GCAGTCCGTGG
CGCAGTTATTT -> GCAGTTATTTT
CGCATATGGCT -> GCATATGGCTA
CGCATTCTGAT -> GCATTCTGATT
CGCATTGAACG -> GCATTGAACGG
CGCATTGACCA -> GCATTGACCAT
CGCCAGGTTTA -> GCCAGGTTTAA
CGCCAGTCCTG -> GCCAGTCCTGT
CGCCATGATTT -> GCCATGATTTG
CGCCCAAAATC -> GCCCAAAATCA
CGCCTTAACGA -> GCCTTAACGAG
CGCCTTATCAA -> GCCTTATCAAA
CGCGACACACC -> GCGACACACCA
CGCGATTATTA -> GCGATTATTAC
CGCGCTACCTT -> GCGCTACCTTA
CGCGCTGCTGC -> GCGCTGCTGCC
CGCGGCTGGAA -> GCGGCTGGAAT
CGCGTATGATT -> GCGTATGATTA
CGCGTCAAATA -> GCGTCAAATAT
CGCGTCAGAGA -> GCGTCAGAGAG
CGCGTCGACTA -> GCGTCGACTAC
CGCGTGCCTAC -> GCGTGCCTACC
CGCTACCTTAT -> GCTACCTTATG
CGCTAGGGGGT -> GCTAGGGGGTT
CGCTATTGCGC -> GCTATTGCGCG
CGCTCAGTGTC -> GCTCAGTGTCC
CGCTGAAGCGG -> GCTGAAGCGGG
CGCTGCTGCCA -> GCTGCTGCCAG
CGCTGGACACT -> GCTGGACACTC
CGCTGGCTCTG -> GCTGGCTCTGG
CGCTTAAACCT -> GCTTAAACCTA
CGCTTTGGCTG -> GCTTTGGCTGA
CGGACATGTTT -> GGACATGTTTA
CGGACTCATCG -> GGACTCATCGT
CGGAGACATAC -> GGAGACATACT
CGGAGGCTGGG -> GGAGGCTGGGC
CGGATGTGCTG -> GGATGTGCTGG
CGGCAGGCTGA -> GGCAGGCTGAG
CGGCATCGCTG -> GGCATCGCTGG
CGGCCCACCTC -> GGCCCACCTCG
CGGCCGCAAGA -> GGCCGCAAGAT
CGGCGAAGCGA -> GGCGAAGCGAC
CGGCTCCCCGA -> GGCTCCCCGAG
CGGCTGGAATT -> GGCTGGAATTT
CGGGGCCTAGT -> GGGGCCTAGTC
CGGGGTTCCAG -> GGGGTTCCAGG
CGGGTAATCCC -> GGGTAATCCCG
CGGGTAGAGTT -> GGGTAGAGTTA
CGGGTCGAAGA -> GGGTCGAAGAT
CGGGTTAATTA -> GGGTTAATTAG
CGGGTTCCGGT -> GGGTTCCGGTT
CGGGTTCCGTA -> GGGTTCCGTAA
CGGTACAATGT -> GGTACAATGTT
CGGTACGCCAG -> GGTACGCCAGT
CGGTATACAAC -> GGTATACAACG
CGGTGGGGTCT -> GGTGGGGTCTG
CGGTTACTGGT -> GGTTACTGGTT
CGGTTGTTTCG -> GGTTGTTTCGG
CGTAAAGTTAG -> GTAAAGTTAGC
CGTAACAGCTC -> GTAACAGCTCC
CGTAACCATAA -> GTAACCATAAC
CGTAATCACGT -> GTAATCACGTC
CGTACAATCTG -> GTACAATCTGC
CGTACACTTAT -> GTACACTTATT
CGTACGACTAG -> GTACGACTAGG
CGTATGATTAG -> GTATGATTAGG
CGTCAAATATT -> GTCAAATATTT
CGTCAGAGAGC -> GTCAGAGAGCA
CGTCATCCCCC -> GTCATCCCCCC
CGTCATCGTAA -> GTCATCGTAAA
CGTCATGATAG -> GTCATGATAGG
CGTCATTTAGT -> GTCATTTAGTG
CGTCGACTACA -> GTCGACTACAG
CGTCGATTTAC -> GTCGATTTACA
CGTCGCCTTAT -> GTCGCCTTATC
CGTCTCGAGCA -> GTCTCGAGCAC
CGTGATTTAAG -> GTGATTTAAGC
CGTGCCTACCG -> GTGCCTACCGC
CGTGCGTACGA -> GTGCGTACGAC
CGTGGCAAGCC -> GTGGCAAGCCG
CGTGGCGATCT -> GTGGCGATCTC
CGTGGTGGTGT -> GTGGTGGTGTT
CGTGTAGTGGT -> GTGTAGTGGTT
CGTGTCGGTTG -> GTGTCGGTTGT
CGTTAGCGCAG -> GTTAGCGCAGT
CGTTGCTTGGT -> GTTGCTTGGTC
CTAAACTCGCG -> TAAACTCGCGT
CTAAAGCTAAG -> TAAAGCTAAGC
CTAACCACCCC -> TAACCACCCCA
CTAACTATGGG -> TAACTATGGGC
CTAAGACGTAC -> TAAGACGTACA
CTAAGCTTTAC -> TAAGCTTTACC
CTAATCCGCTG -> TAATCCGCTGG
CTAATGAAGCT -> TAATGAAGCTC
CTAATGTTTAT -> TAATGTTTATG
CTACAGGTTCT -> TACAGGTTCTG
CTACATGAACC -> TACATGAACCG
CTACATGCCTT -> TACATGCCTTA
CTACCGAGGCC -> TACCGAGGCCT
CTACCGCAAGG -> TACCGCAAGGC
CTACCGCCTTA -> TACCGCCTTAA
CTACCTTATGT -> TACCTTATGTT
CTACGGCAGGC -> TACGGCAGGCT
CTACGGTACGC -> TACGGTACGCC
CTACGTCGATT -> TACGTCGATTT
CTACTTACTTC -> TACTTACTTCA
CTAGGGGGAGG -> TAGGGGGAGGG
CTAGGGGGTTT -> TAGGGGGTTTC
CTAGGTCTGTT -> TAGGTCTGTTT
CTAGTCGGGTT -> TAGTCGGGTTA
CTAGTTTTAAG -> TAGTTTTAAGG
CTATAGCTTAC -> TATAGCTTACG
CTATAGGACGA -> TATAGGACGAA
CTATATATCCT -> TATATATCCTA
CTATGGGCATT -> TATGGGCATTC
CTATGTCGCCC -> TATGTCGCCCA
CTATTGCATCG -> TATTGCATCGA
CTATTGCGCGC -> TATTGCGCGCT
CTCAAATTCTA -> TCAAATTCTAC
CTCAACGAAGT -> TCAACGAAGTT
CTCACGAACAT -> TCACGAACATA
CTCAGTGTCCA -> TCAGTGTCCAT
CTCATAAACAG -> TCATAAACAGT
CTCATCGTTGC -> TCATCGTTGCT
CTCATTTCCAT -> TCATTTCCATA
CTCCAACGCGT -> TCCAACGCGTG
CTCCCATGGTC -> TCCCATGGTCA
CTCCCCCGTGG -> TCCCCCGTGGC
CTCCCCGAGAC -> TCCCCGAGACT
CTCCGACGAAG -> TCCGACGAAGT
CTCCGAGGGCT -> TCCGAGGGCTC
CTCCTATAGGA -> TCCTATAGGAC
CTCGAACGCCA -> TCGAACGCCAT
CTCGAGCACTC -> TCGAGCACTCG
CTCGCAAAGTC -> TCGCAAAGTCC
CTCGCGTATGA -> TCGCGTATGAT
CTCGGACATGT -> TCGGACATGTT
CTCGGCTCCCC -> TCGGCTCCCCG
CTCGGTACAAT -> TCGGTACAATG
CTCGTCATCCC -> TCGTCATCCCC
CTCGTGGCAAG -> TCGTGGCAAGC
CTCGTGTAGTG -> TCGTGTAGTGG
CTCTACATGAA -> TCTACATGAAC
CTCTCCCCCGT -> TCTCCCCCGTG
CTCTCGGTACA -> TCTCGGTACAA
CTCTGCCGCGC -> TCTGCCGCGCT
CTCTGGGATCT -> TCTGGGATCTG
CTCTTACAGAG -> TCTTACAGAGT
CTGAAGCGGGG -> TGAAGCGGGGT
CTGACACGAAG -> TGACACGAAGG
CTGACATCTCG -> TGACATCTCGT
CTGACGGGTAG -> TGACGGGTAGA
CTGAGCACAAA -> TGAGCACAAAG
CTGAGCTAATG -> TGAGCTAATGT
CTGAGTATCCA -> TGAGTATCCAC
CTGAGTATGAC -> TGAGTATGACT
CTGATTGGGGG -> TGATTGGGGGG
CTGATTTGTAT -> TGATTTGTATC
CTGCCAGGAGA -> TGCCAGGAGAG
CTGCCGCGCTA -> TGCCGCGCTAC
CTGCCTGTCGA -> TGCCTGTCGAC
CTGCGGGTCGA -> TGCGGGTCGAA
CTGCTCTACAT -> TGCTCTACATG
CTGCTGCCAGG -> TGCTGCCAGGA
CTGCTTATGCG -> TGCTTATGCGC
CTGGAATTTTT -> TGGAATTTTTC
CTGGACACTCA -> TGGACACTCAT
CTGGATAGTCT -> TGGATAGTCTG
CTGGCCAACGA -> TGGCCAACGAC
CTGGCCCTCGC -> TGGCCCTCGCA
CTGGCGAGATG -> TGGCGAGATGA
CTGGCTCTGGG -> TGGCTCTGGGA
CTGGCTTTAGA -> TGGCTTTAGAC
CTGGGATCTGC -> TGGGATCTGCG
CTGGGCGGAGA -> TGGGCGGAGAC
CTGGTTGTCGA -> TGGTTGTCGAG
CTGTCATTCTT -> TGTCATTCTTT
CTGTCGACGCA -> TGTCGACGCAG
CTGTCGGCCCA -> TGTCGGCCCAC
CTGTGAATATT -> TGTGAATATTC
CTGTGCTATTG -> TGTGCTATTGC
CTGTGTCGCTT -> TGTGTCGCTTA
CTGTGTGCACG -> TGTGTGCACGT
CTGTTAGACCA -> TGTTAGACCAA
CTGTTTAGGTA -> TGTTTAGGTAA
CTTAAACCTAA -> TTAAACCTAAG
CTTAACGAGAA -> TTAACGAGAAA
CTTAACTACAT -> TTAACTACATG
CTTAATACTTG -> TTAATACTTGT
CTTACAGAGTC -> TTACAGAGTCT
CTTACGCGATT -> TTACGCGATTA
CTTACTATAGC -> TTACTATAGCT
CTTACTTCACC -> TTACTTCACCC
CTTATCAAAGT -> TTATCAAAGTT
CTTATCTGTCA -> TTATCTGTCAT
CTTATGCGCGT -> TTATGCGCGTC
CTTATGGCTGG -> TTATGGCTGGC
CTTATGTTACT -> TTATGTTACTG
CTTATTTCCCT -> TTATTTCCCTG
CTTCAAGTCAT -> TTCAAGTCATC
CTTCACCCGGA -> TTCACCCGGAC
CTTCCAGTTAA -> TTCCAGTTAAA
CTTCTGTCGGC -> TTCTGTCGGCC
CTTCTTGTTAT -> TTCTTGTTATC
CTTGCCGCCAG -> TTGCCGCCAGG
CTTGGTCTAAC -> TTGGTCTAACT
CTTGTGACGAC -> TTGTGACGACC
CTTGTTATCAC -> TTGTTATCACC
CTTTACCTTCT -> TTTACCTTCTT
CTTTAGACTAG -> TTTAGACTAGG
CTTTGGCTGAG -> TTTGGCTGAGC
CTTTTAGACCA -> TTTTAGACCAC
GAAAAACCCCA -> AAAAACCCCAT
GAAAACAGCGA -> AAAACAGCGAT
GAAAATTGGGA -> AAAATTGGGAG
GAAAGACATTC -> AAAGACATTCT
GAAAGTGTTGG -> AAAGTGTTGGA
GAAAGTTTTAC -> AAAGTTTTACC
GAAATCGATCT -> AAATCGATCTT
GAAATGCCGAG -> AAATGCCGAGG
GAACAACATGG -> AACAACATGGT
GAACACTTATG -> AACACTTATGG
GAACATAGTGC -> AACATAGTGCA
GAACCGAAGTG -> AACCGAAGTGT
GAACGCCATGA -> AACGCCATGAT
GAACGGGTTCC -> AACGGGTTCCG
GAACTGTGAAT -> AACTGTGAATA
GAAGATCTTAT -> AAGATCTTATC
GAAGCAAACAC -> AAGCAAACACC
GAAGCGACATG -> AAGCGACATGT
GAAGCGGGGTT -> AAGCGGGGTTC
GAAGCTCATTT -> AAGCTCATTTC
GAAGGTTGGAT -> AAGGTTGGATC
GAAGTGTATGA -> AAGTGTATGAT
GAAGTTCTCCA -> AAGTTCTCCAA
GAAGTTGCAAC -> AAGTTGCAACG
GAATATTCCGG -> AATATTCCGGG
GAATCTAATGA -> AATCTAATGAA
GAATCTGAGCT -> AATCTGAGCTA
GAATGACGCAA -> AATGACGCAAC
GAATGCTCTCG -> AATGCTCTCGG
GAATGTTCACC -> AATGTTCACCG
GAATTTTTCTA -> AATTTTTCTAC
GACACACCAAA -> ACACACCAAAC
GACACGAAGGT -> ACACGAAGGTT
GACACTCATAA -> ACACTCATAAA
GACAGCGTCTC -> ACAGCGTCTCG
GACATACTCGG -> ACATACTCGGA
GACATCTCGTG -> ACATCTCGTGG
GACATGAAATG -> ACATGAAATGC
GACATGTGTAC -> ACATGTGTACC
GACATGTTTAA -> ACATGTTTAAC
GACATTCTCAA -> ACATTCTCAAC
GACCAAAGGGA -> ACCAAAGGGAT
GACCACGGTGG -> ACCACGGTGGG
GACCATTCAAC -> ACCATTCAACG
GACCCTAAACT -> ACCCTAAACTC
GACCCTCGTCA -> ACCCTCGTCAT
GACCGCTTTGG -> ACCGCTTTGGC
GACGAAAATTG -> ACGAAAATTGG
GACGAAGTTCT -> ACGAAGTTCTC
GACGAATGCTC -> ACGAATGCTCT
GACGACCCTCG -> ACGACCCTCGT
GACGCAACCCG -> ACGCAACCCGT
GACGCAGCAAG -> ACGCAGCAAGA
GACGGGTAGAG -> ACGGGTAGAGT
GACGGTATACA -> ACGGTATACAA
GACGTACAATC -> ACGTACAATCT
GACGTACACTT -> ACGTACACTTA
GACTACAGGTT -> ACTACAGGTTC
GACTACCGCAA -> ACTACCGCAAG
GACTACGGTAC -> ACTACGGTACG
GACTAGGGGGA -> ACTAGGGGGAG
GACTAGGTCTG -> ACTAGGTCTGT
GACTCATCGTT -> ACTCATCGTTG
GACTCTCCCCC -> ACTCTCCCCCG
GACTGATTTGT -> ACTGATTTGTA
GAGAAAAACCC -> AGAAAAACCCC
GAGAAAGACAT -> AGAAAGACATT
GAGAATGACGC -> AGAATGACGCA
GAGACATACTC -> AGACATACTCG
GAGACTCTCCC -> AGACTCTCCCC
GAGAGAAAGAC -> AGAGAAAGACA
GAGAGCATCAC -> AGAGCATCACG
GAGAGTTTATA -> AGAGTTTATAA
GAGATGAATGT -> AGATGAATGTT
GAGCACAAAGT -> AGCACAAAGTC
GAGCACTCGAA -> AGCACTCGAAC
GAGCATACACC -> AGCATACACCG
GAGCATCACGC -> AGCATCACGCA
GAGCTAATGTT -> AGCTAATGTTT
GAGGCCTAATC -> AGGCCTAATCC
GAGGCTGGGCG -> AGGCTGGGCGG
GAGGGCCCTGA -> AGGGCCCTGAC
GAGGGCTCGGC -> AGGGCTCGGCT
GAGGGGAATCT -> AGGGGAATCTA
GAGGTCCATCA -> AGGTCCATCAA
GAGGTTCGCTC -> AGGTTCGCTCA
GAGGTTCTTAA -> AGGTTCTTAAC
GAGTATCCACC -> AGTATCCACCG
GAGTATGACTG -> AGTATGACTGA
GAGTCTTCTGT -> AGTCTTCTGTC
GAGTTACGATT -> AGTTACGATTG
GAGTTTATAAC -> AGTTTATAACG
GAGTTTCTAAA -> AGTTTCTAAAG
GATAAATAGAC -> ATAAATAGACT
GATAGGTCCCG -> ATAGGTCCCGG
GATAGTCTGAC -> ATAGTCTGACG
GATCCCTGCTT -> ATCCCTGCTTA
GATCTCTGCCG -> ATCTCTGCCGC
GATCTCTTACA -> ATCTCTTACAG
GATCTGCGGGT -> ATCTGCGGGTC
GATCTGGCGAG -> ATCTGGCGAGA
GATCTTATCTG -> ATCTTATCTGT
GATCTTCAAGT -> ATCTTCAAGTC
GATGAATGTTC -> ATGAATGTTCA
GATGACGAAAA -> ATGACGAAAAT
GATGGTCCAAA -> ATGGTCCAAAC
GATGTGCTGGA -> ATGTGCTGGAT
GATTAGGTAAG -> ATTAGGTAAGG
GATTATAACGT -> ATTATAACGTG
GATTATTACAT -> ATTATTACATT
GATTGCTAACC -> ATTGCTAACCA
GATTGGGGGGA -> ATTGGGGGGAA
GATTTAAGCGC -> ATTTAAGCGCT
GATTTACATTG -> ATTTACATTGG
GATTTGTATCC -> ATTTGTATCCT
GATTTGTCTTC -> ATTTGTCTTCC
GATTTGTGCTG -> ATTTGTGCTGT
GCAAACACCAG -> CAAACACCAGG
GCAAAGTCCCA -> CAAAGTCCCAT
GCAACCCGTGC -> CAACCCGTGCG
GCAACGTCGCC -> CAACGTCGCCT
GCAAGAGGTTC -> CAAGAGGTTCT
GCAAGATTATA -> CAAGATTATAA
GCAAGCCGGGT -> CAAGCCGGGTA
GCAAGGCACTT -> CAAGGCACTTA
GCACAAAGTCA -> CACAAAGTCAT
GCACGTAATCA -> CACGTAATCAC
GCACTCGAACG -> CACTCGAACGC
GCACTTACTAT -> CACTTACTATA
GCAGAGAATGA -> CAGAGAATGAC
GCAGAGGTTCG -> CAGAGGTTCGC
GCAGCAAGAGG -> CAGCAAGAGGT
GCAGGCTGAGT -> CAGGCTGAGTA
GCAGTCCGTGG -> CAGTCCGTGGT
GCAGTTATTTT -> CAGTTATTTTG
GCATACACCGA -> CATACACCGAC
GCATATGGCTA -> CATATGGCTAT
GCATCACGCAT -> CATCACGCATT
GCATCGAGAGT -> CATCGAGAGTT
GCATCGCTGGA -> CATCGCTGGAC
GCATTCAAAGA -> CATTCAAAGAC
GCATTCTGATT -> CATTCTGATTG
GCATTGAACGG -> CATTGAACGGG
GCATTGACCAT -> CATTGACCATT
GCCAACGACGT -> CCAACGACGTA
GCCAGGAGAGA -> CCAGGAGAGAA
GCCAGGTTTAA -> CCAGGTTTAAC
GCCAGTCCTGT -> CCAGTCCTGTG
GCCATGATTTG -> CCATGATTTGT
GCCCAAAATCA -> CCCAAAATCAT
GCCCACCTCGT -> CCCACCTCGTG
GCCCTCGCAAA -> CCCTCGCAAAG
GCCCTGACATC -> CCCTGACATCT
GCCGAGCATAC -> CCGAGCATACA
GCCGAGGGCCC -> CCGAGGGCCCT
GCCGCAAGATT -> CCGCAAGATTA
GCCGCCAGGTT -> CCGCCAGGTTT
GCCGCGCTACC -> CCGCGCTACCT
GCCGGGTAATC -> CCGGGTAATCC
GCCTAATCCGC -> CCTAATCCGCT
GCCTACCGCCT -> CCTACCGCCTT
GCCTAGTCGGG -> CCTAGTCGGGT
GCCTGTCGACG -> CCTGTCGACGC
GCCTGTTAGAC -> CCTGTTAGACC
GCCTTAACGAG -> CCTTAACGAGA
GCCTTAATACT -> CCTTAATACTT
GCCTTATCAAA -> CCTTATCAAAG
GCGAAGCGACA -> CGAAGCGACAT
GCGACACACCA -> CGACACACCAA
GCGACATGTGT -> CGACATGTGTA
GCGAGATGAAT -> CGAGATGAATG
GCGATCTCTGC -> CGATCTCTGCC
GCGATGACGAA -> CGATGACGAAA
GCGATTATTAC -> CGATTATTACA
GCGCAGTCCGT -> CGCAGTCCGTG
GCGCGCTGCTG -> CGCGCTGCTGC
GCGCGTCAAAT -> CGCGTCAAATA
GCGCTACCTTA -> CGCTACCTTAT
GCGCTGAAGCG -> CGCTGAAGCGG
GCGCTGCTGCC -> CGCTGCTGCCA
GCGGAGACATA -> CGGAGACATAC
GCGGCTGGAAT -> CGGCTGGAATT
GCGGGGTTCCA -> CGGGGTTCCAG
GCGGGTCGAAG -> CGGGTCGAAGA
GCGTACGACTA -> CGTACGACTAG
GCGTATGATTA -> CGTATGATTAG
GCGTCAAATAT -> CGTCAAATATT
GCGTCAGAGAG -> CGTCAGAGAGC
GCGTCGACTAC -> CGTCGACTACA
GCGTCTCGAGC -> CGTCTCGAGCA
GCGTGCCTACC -> CGTGCCTACCG
GCTAACCACCC -> CTAACCACCCC
GCTAAGCTTTA -> CTAAGCTTTAC
GCTAATGTTTA -> CTAATGTTTAT
GCTACCTTATG -> CTACCTTATGT
GCTAGGGGGTT -> CTAGGGGGTTT
GCTATGTCGCC -> CTATGTCGCCC
GCTATTGCATC -> CTATTGCATCG
GCTATTGCGCG -> CTATTGCGCGC
GCTCAGTGTCC -> CTCAGTGTCCA
GCTCATTTCCA -> CTCATTTCCAT
GCTCCCCGAGA -> CTCCCCGAGAC
GCTCCGACGAA -> CTCCGACGAAG
GCTCCGAGGGC -> CTCCGAGGGCT
GCTCCTATAGG -> CTCCTATAGGA
GCTCGGCTCCC -> CTCGGCTCCCC
GCTCTACATGA -> CTCTACATGAA
GCTCTCGGTAC -> CTCTCGGTACA
GCTCTGGGATC -> CTCTGGGATCT
GCTGAAGCGGG -> CTGAAGCGGGG
GCTGAGCACAA -> CTGAGCACAAA
GCTGAGTATGA -> CTGAGTATGAC
GCTGCCAGGAG -> CTGCCAGGAGA
GCTGCTGCCAG -> CTGCTGCCAGG
GCTGGAATTTT -> CTGGAATTTTT
GCTGGACACTC -> CTGGACACTCA
GCTGGATAGTC -> CTGGATAGTCT
GCTGGCCAACG -> CTGGCCAACGA
GCTGGCTCTGG -> CTGGCTCTGGG
GCTGGGCGGAG -> CTGGGCGGAGA
GCTGTGTCGCT -> CTGTGTCGCTT
GCTTAAACCTA -> CTTAAACCTAA
GCTTACGCGAT -> CTTACGCGATT
GCTTATGCGCG -> CTTATGCGCGT
GCTTGCCGCCA -> CTTGCCGCCAG
GCTTGGTCTAA -> CTTGGTCTAAC
GCTTTACCTTC -> CTTTACCTTCT
GCTTTAGACTA -> CTTTAGACTAG
GCTTTGGCTGA -> CTTTGGCTGAG
GGAAAGTGTTG -> GAAAGTGTTGG
GGAAATCGATC -> GAAATCGATCT
GGAACAACATG -> GAACAACATGG
GGAATCTAATG -> GAATCTAATGA
GGAATTTTTCT -> GAATTTTTCTA
GGACACTCATA -> GACACTCATAA
GGACAGCGTCT -> GACAGCGTCTC
GGACATGTTTA -> GACATGTTTAA
GGACCGCTTTG -> GACCGCTTTGG
GGACGAATGCT -> GACGAATGCTC
GGACTCATCGT -> GACTCATCGTT
GGAGACATACT -> GAGACATACTC
GGAGAGAAAGA -> GAGAGAAAGAC
GGAGGCTGGGC -> GAGGCTGGGCG
GGAGGGGAATC -> GAGGGGAATCT
GGAGGTCCATC -> GAGGTCCATCA
GGATAGTCTGA -> GATAGTCTGAC
GGATCTCTTAC -> GATCTCTTACA
GGATCTGCGGG -> GATCTGCGGGT
GGATGTGCTGG -> GATGTGCTGGA
GGATTTGTCTT -> GATTTGTCTTC
GGCAAGCCGGG -> GCAAGCCGGGT
GGCACTTACTA -> GCACTTACTAT
GGCAGGCTGAG -> GCAGGCTGAGT
GGCATCGCTGG -> GCATCGCTGGA
GGCATTCAAAG -> GCATTCAAAGA
GGCCAACGACG -> GCCAACGACGT
GGCCCACCTCG -> GCCCACCTCGT
GGCCCTCGCAA -> GCCCTCGCAAA
GGCCCTGACAT -> GCCCTGACATC
GGCCGCAAGAT -> GCCGCAAGATT
GGCCTAATCCG -> GCCTAATCCGC
GGCCTAGTCGG -> GCCTAGTCGGG
GGCCTGTTAGA -> GCCTGTTAGAC
GGCGAAGCGAC -> GCGAAGCGACA
GGCGAGATGAA -> GCGAGATGAAT
GGCGATCTCTG -> GCGATCTCTGC
GGCGGAGACAT -> GCGGAGACATA
GGCTATGTCGC -> GCTATGTCGCC
GGCTCCCCGAG -> GCTCCCCGAGA
GGCTCCGAGGG -> GCTCCGAGGGC
GGCTCGGCTCC -> GCTCGGCTCCC
GGCTCTGGGAT -> GCTCTGGGATC
GGCTGAGCACA -> GCTGAGCACAA
GGCTGAGTATG -> GCTGAGTATGA
GGCTGGAATTT -> GCTGGAATTTT
GGCTGGCCAAC -> GCTGGCCAACG
GGCTGGGCGGA -> GCTGGGCGGAG
GGCTTTAGACT -> GCTTTAGACTA
GGGAAAGTGTT -> GGAAAGTGTTG
GGGAACAACAT -> GGAACAACATG
GGGAATCTAAT -> GGAATCTAATG
GGGAGGGGAAT -> GGAGGGGAATC
GGGAGGTCCAT -> GGAGGTCCATC
GGGATCTGCGG -> GGATCTGCGGG
GGGATTTGTCT -> GGATTTGTCTT
GGGCATTCAAA -> GGCATTCAAAG
GGGCCCTGACA -> GGCCCTGACAT
GGGCCTAGTCG -> GGCCTAGTCGG
GGGCGGAGACA -> GGCGGAGACAT
GGGCTCGGCTC -> GGCTCGGCTCC
GGGGAAAGTGT -> GGGAAAGTGTT
GGGGAACAACA -> GGGAACAACAT
GGGGAATCTAA -> GGGAATCTAAT
GGGGAGGGGAA -> GGGAGGGGAAT
GGGGCCTAGTC -> GGGCCTAGTCG
GGGGGAACAAC -> GGGGAACAACA
GGGGGAGGGGA -> GGGGAGGGGAA
GGGGGGAACAA -> GGGGGAACAAC
GGGGGTTTCCG -> GGGGTTTCCGC
GGGGTCTGTGC -> GGGTCTGTGCT
GGGGTTCCAGG -> GGGTTCCAGGA
GGGGTTTCCGC -> GGGTTTCCGCG
GGGTAATCCCG -> GGTAATCCCGT
GGGTAGAGTTA -> GGTAGAGTTAC
GGGTCGAAGAT -> GGTCGAAGATC
GGGTCTGTGCT -> GGTCTGTGCTA
GGGTTAATTAG -> GGTTAATTAGG
GGGTTCCAGGA -> GGTTCCAGGAC
GGGTTCCGGTT -> GGTTCCGGTTA
GGGTTCCGTAA -> GGTTCCGTAAC
GGGTTTCCGCG -> GGTTTCCGCGG
GGTAAAGTTAT -> GTAAAGTTATA
GGTAAGGCTCC -> GTAAGGCTCCG
GGTAATCCCGT -> GTAATCCCGTT
GGTACAATGTT -> GTACAATGTTG
GGTACGCCAGT -> GTACGCCAGTC
GGTACTCAAAT -> GTACTCAAATT
GGTAGAGTTAC -> GTAGAGTTACG
GGTAGATCCCT -> GTAGATCCCTG
GGTAGTGAAGC -> GTAGTGAAGCA
GGTATACAACG -> GTATACAACGT
GGTCAACGATG -> GTCAACGATGG
GGTCCAAACGA -> GTCCAAACGAC
GGTCCATCAAC -> GTCCATCAACA
GGTCCATGAAA -> GTCCATGAAAA
GGTCCCGGAGG -> GTCCCGGAGGC
GGTCGAAGATC -> GTCGAAGATCT
GGTCTAACTAT -> GTCTAACTATG
GGTCTGTGCTA -> GTCTGTGCTAT
GGTCTGTTTAG -> GTCTGTTTAGG
GGTGAATCTGA -> GTGAATCTGAG
GGTGGGGTCTG -> GTGGGGTCTGT
GGTGGTGTTGG -> GTGGTGTTGGT
GGTGTAGGTGA -> GTGTAGGTGAA
GGTGTTGGTGT -> GTGTTGGTGTA
GGTTAATTAGG -> GTTAATTAGGT
GGTTACTGGTT -> GTTACTGGTTG
GGTTCCAGGAC -> GTTCCAGGACC
GGTTCCGGTTA -> GTTCCGGTTAC
GGTTCCGTAAC -> GTTCCGTAACA
GGTTCGCTCAG -> GTTCGCTCAGT
GGTTCTGGCCC -> GTTCTGGCCCT
GGTTCTTAACT -> GTTCTTAACTA
GGTTGAACACT -> GTTGAACACTT
GGTTGGATCTC -> GTTGGATCTCT
GGTTGTCGAGT -> GTTGTCGAGTT
GGTTGTTTCGG -> GTTGTTTCGGA
GGTTTAACTGG -> GTTTAACTGGC
GGTTTCCGCGG -> GTTTCCGCGGC
GTAAAGTTAGC -> TAAAGTTAGCT
GTAAAGTTATA -> TAAAGTTATAG
GTAACAGCTCC -> TAACAGCTCCT
GTAACCATAAC -> TAACCATAACC
GTAAGGCTCCG -> TAAGGCTCCGA
GTAATCACGTC -> TAATCACGTCA
GTAATCCCGTT -> TAATCCCGTTA
GTACAATCTGC -> TACAATCTGCC
GTACAATGTTG -> TACAATGTTGA
GTACACTTATT -> TACACTTATTT
GTACCGTAACC -> TACCGTAACCA
GTACGACTAGG -> TACGACTAGGT
GTACGCCAGTC -> TACGCCAGTCC
GTACGGCATCG -> TACGGCATCGC
GTACTCAAATT -> TACTCAAATTC
GTAGAGTTACG -> TAGAGTTACGA
GTAGATCCCTG -> TAGATCCCTGC
GTAGGTGAATC -> TAGGTGAATCT
GTAGTGAAGCA -> TAGTGAAGCAA
GTAGTGGTTGA -> TAGTGGTTGAA
GTATACAACGT -> TATACAACGTC
GTATCCACCGG -> TATCCACCGGC
GTATCCTATAT -> TATCCTATATA
GTATGACTGAT -> TATGACTGATT
GTATGATCTGG -> TATGATCTGGC
GTATGATTAGG -> TATGATTAGGT
GTCAAATATTT -> TCAAATATTTC
GTCAACGATGG -> TCAACGATGGT
GTCAGAGAGCA -> TCAGAGAGCAT
GTCATAGAAAG -> TCATAGAAAGT
GTCATCCCCCC -> TCATCCCCCCG
GTCATCGCGAC -> TCATCGCGACA
GTCATCGGGTT -> TCATCGGGTTC
GTCATCGTAAA -> TCATCGTAAAG
GTCATGATAGG -> TCATGATAGGT
GTCATTCCAGT -> TCATTCCAGTT
GTCATTCTTTT -> TCATTCTTTTA
GTCATTTAGTG -> TCATTTAGTGA
GTCCAAACGAC -> TCCAAACGACA
GTCCATAATCA -> TCCATAATCAC
GTCCATCAACA -> TCCATCAACAA
GTCCATGAAAA -> TCCATGAAAAC
GTCCCATAAAA -> TCCCATAAAAG
GTCCCGGAGGC -> TCCCGGAGGCT
GTCCGTGGTGG -> TCCGTGGTGGT
GTCCTGTGTGC -> TCCTGTGTGCA
GTCGAAGATCT -> TCGAAGATCTT
GTCGACGCAGC -> TCGACGCAGCA
GTCGACTACAG -> TCGACTACAGG
GTCGAGTTTCT -> TCGAGTTTCTA
GTCGATTTACA -> TCGATTTACAT
GTCGCCCAAAA -> TCGCCCAAAAT
GTCGCCTTATC -> TCGCCTTATCA
GTCGCTTAAAC -> TCGCTTAAACC
GTCGGCCCACC -> TCGGCCCACCT
GTCGGGTTAAT -> TCGGGTTAATT
GTCGGTTGTTT -> TCGGTTGTTTC
GTCTAACTATG -> TCTAACTATGG
GTCTCGAGCAC -> TCTCGAGCACT
GTCTGACGGGT -> TCTGACGGGTA
GTCTGTGCTAT -> TCTGTGCTATT
GTCTGTTTAGG -> TCTGTTTAGGT
GTCTTCCAGTT -> TCTTCCAGTTA
GTCTTCTGTCG -> TCTTCTGTCGG
GTGAAGCAAAC -> TGAAGCAAACA
GTGAATATTCC -> TGAATATTCCG
GTGAATCTGAG -> TGAATCTGAGC
GTGACGACCCT -> TGACGACCCTC
GTGATAAATAG -> TGATAAATAGA
GTGATTTAAGC -> TGATTTAAGCG
GTGCACGTAAT -> TGCACGTAATC
GTGCAGAGGTT -> TGCAGAGGTTC
GTGCCTACCGC -> TGCCTACCGCC
GTGCGTACGAC -> TGCGTACGACT
GTGCTATTGCA -> TGCTATTGCAT
GTGCTGGATAG -> TGCTGGATAGT
GTGCTGTGTCG -> TGCTGTGTCGC
GTGGCAAGCCG -> TGGCAAGCCGG
GTGGCGATCTC -> TGGCGATCTCT
GTGGGGTCTGT -> TGGGGTCTGTG
GTGGTGGTGTT -> TGGTGGTGTTG
GTGGTGTTGGT -> TGGTGTTGGTG
GTGGTTGAACA -> TGGTTGAACAC
GTGTACCGTAA -> TGTACCGTAAC
GTGTAGGTGAA -> TGTAGGTGAAT
GTGTAGTGGTT -> TGTAGTGGTTG
GTGTATGATCT -> TGTATGATCTG
GTGTCATCGGG -> TGTCATCGGGT
GTGTCCATAAT -> TGTCCATAATC
GTGTCGCTTAA -> TGTCGCTTAAA
GTGTCGGTTGT -> TGTCGGTTGTT
GTGTGCACGTA -> TGTGCACGTAA
GTGTGTCATCG -> TGTGTCATCGG
GTGTTGGACAG -> TGTTGGACAGC
GTGTTGGTGTA -> TGTTGGTGTAG
GTTAAATATCC -> TTAAATATCCC
GTTAATTAGGT -> TTAATTAGGTA
GTTACGATTGC -> TTACGATTGCT
GTTACTGACAC -> TTACTGACACG
GTTACTGGTTG -> TTACTGGTTGT
GTTAGACCAAA -> TTAGACCAAAG
GTTAGCGCAGT -> TTAGCGCAGTC
GTTAGCTTGCC -> TTAGCTTGCCG
GTTATAGGGGA -> TTATAGGGGAA
GTTATCACCAC -> TTATCACCACT
GTTATTTTGTG -> TTATTTTGTGT
GTTCACCGCTA -> TTCACCGCTAG
GTTCACGCATT -> TTCACGCATTG
GTTCCACTACG -> TTCCACTACGG
GTTCCAGGACC -> TTCCAGGACCG
GTTCCGGTTAC -> TTCCGGTTACT
GTTCCGTAACA -> TTCCGTAACAG
GTTCGCTCAGT -> TTCGCTCAGTG
GTTCTCCAACG -> TTCTCCAACGC
GTTCTGGCCCT -> TTCTGGCCCTC
GTTCTTAACTA -> TTCTTAACTAC
GTTGAACACTT -> TTGAACACTTA
GTTGAACTGTG -> TTGAACTGTGA
GTTGCAACGTC -> TTGCAACGTCG
GTTGCTTGGTC -> TTGCTTGGTCT
GTTGGACAGCG -> TTGGACAGCGT
GTTGGATCTCT -> TTGGATCTCTT
GTTGGTGTAGG -> TTGGTGTAGGT
GTTGTCGAGTT -> TTGTCGAGTTT
GTTGTTTCGGA -> TTGTTTCGGAT
GTTTAACTCCC -> TTTAACTCCCA
GTTTAACTGGC -> TTTAACTGGCT
GTTTAGGTAAA -> TTTAGGTAAAG
GTTTATAACGC -> TTTATAACGCA
GTTTATGCTCC -> TTTATGCTCCG
GTTTCCGCGGC -> TTTCCGCGGCT
GTTTCGGATGT -> TTTCGGATGTG
GTTTCTAAAGC -> TTTCTAAAGCT
GTTTTAAGGCC -> TTTTAAGGCCT
GTTTTACCTGC -> TTTTACCTGCT
TAAACAGTCAT -> AAACAGTCATA
TAAACCTAAGA -> AAACCTAAGAC
TAAACTCGCGT -> AAACTCGCGTA
TAAAGCTAAGC -> AAAGCTAAGCT
TAAAGTTAGCT -> AAAGTTAGCTT
TAAAGTTATAG -> AAAGTTATAGG
TAAATAGACTA -> AAATAGACTAC
TAAATATCCCA -> AAATATCCCAA
TAACAGCTCCT -> AACAGCTCCTA
TAACCACCCCA -> AACCACCCCAG
TAACCATAACC -> AACCATAACCG
TAACCGTGATT -> AACCGTGATTT
TAACGAGAAAA -> AACGAGAAAAA
TAACGCATTCT -> AACGCATTCTG
TAACGTGTCGG -> AACGTGTCGGT
TAACTACATGC -> AACTACATGCC
TAACTATGGGC -> AACTATGGGCA
TAACTCCCATG -> AACTCCCATGG
TAACTGGCTTT -> AACTGGCTTTA
TAAGACGTACA -> AAGACGTACAC
TAAGCGCTGAA -> AAGCGCTGAAG
TAAGCTTTACC -> AAGCTTTACCT
TAAGGAAATCG -> AAGGAAATCGA
TAAGGCCTGTT -> AAGGCCTGTTA
TAAGGCTCCGA -> AAGGCTCCGAG
TAATACTTGTG -> AATACTTGTGA
TAATCACGCAG -> AATCACGCAGT
TAATCACGTCA -> AATCACGTCAT
TAATCCCGTTA -> AATCCCGTTAG
TAATCCGCTGG -> AATCCGCTGGC
TAATGAAGCTC -> AATGAAGCTCA
TAATGTTTATG -> AATGTTTATGC
TAATTAGGTAC -> AATTAGGTACT
TAATTCGTCAT -> AATTCGTCATT
TACAACGTCAT -> ACAACGTCATC
TACAATCTGCC -> ACAATCTGCCT
TACAATGTTGA -> ACAATGTTGAA
TACACCGACTA -> ACACCGACTAC
TACACTTATTT -> ACACTTATTTC
TACAGAGTCTT -> ACAGAGTCTTC
TACAGGTTCTG -> ACAGGTTCTGG
TACATGAACCG -> ACATGAACCGA
TACATGCCTTA -> ACATGCCTTAA
TACATTGGTAG -> ACATTGGTAGA
TACATTTGCCG -> ACATTTGCCGA
TACCGAGGCCT -> ACCGAGGCCTA
TACCGCAAGGC -> ACCGCAAGGCA
TACCGCCTTAA -> ACCGCCTTAAC
TACCGTAACCA -> ACCGTAACCAT
TACCTGCTCTA -> ACCTGCTCTAC
TACCTTATGTT -> ACCTTATGTTA
TACCTTCTTGT -> ACCTTCTTGTT
TACGACTAGGT -> ACGACTAGGTC
TACGATTGCTA -> ACGATTGCTAA
TACGCCAGTCC -> ACGCCAGTCCT
TACGCGATTAT -> ACGCGATTATT
TACGGCAGGCT -> ACGGCAGGCTG
TACGGCATCGC -> ACGGCATCGCT
TACGGTACGCC -> ACGGTACGCCA
TACGTCGATTT -> ACGTCGATTTA
TACTATAGCTT -> ACTATAGCTTA
TACTCAAATTC -> ACTCAAATTCT
TACTCGGACAT -> ACTCGGACATG
TACTGACACGA -> ACTGACACGAA
TACTGGTTGTC -> ACTGGTTGTCG
TACTTACTTCA -> ACTTACTTCAC
TACTTCACCCG -> ACTTCACCCGG
TACTTGTGACG -> ACTTGTGACGA
TAGAAAGTTTT -> AGAAAGTTTTA
TAGACCAAAGG -> AGACCAAAGGG
TAGACCACGGT -> AGACCACGGTG
TAGACTACCGC -> AGACTACCGCA
TAGACTAGGGG -> AGACTAGGGGG
TAGAGTTACGA -> AGAGTTACGAT
TAGATCCCTGC -> AGATCCCTGCT
TAGCGCAGTCC -> AGCGCAGTCCG
TAGCTTACGCG -> AGCTTACGCGA
TAGCTTGCCGC -> AGCTTGCCGCC
TAGGACGAATG -> AGGACGAATGC
TAGGGGAAAGT -> AGGGGAAAGTG
TAGGGGGAGGG -> AGGGGGAGGGG
TAGGGGGTTTC -> AGGGGGTTTCC
TAGGTAAAGTT -> AGGTAAAGTTA
TAGGTAAGGCT -> AGGTAAGGCTC
TAGGTACTCAA -> AGGTACTCAAA
TAGGTCCCGGA -> AGGTCCCGGAG
TAGGTCTGTTT -> AGGTCTGTTTA
TAGGTGAATCT -> AGGTGAATCTG
TAGTCGGGTTA -> AGTCGGGTTAA
TAGTCTGACGG -> AGTCTGACGGG
TAGTGAAGCAA -> AGTGAAGCAAA
TAGTGATAAAT -> AGTGATAAATA
TAGTGCAGAGG -> AGTGCAGAGGT
TAGTGGTTGAA -> AGTGGTTGAAC
TAGTTTTAAGG -> AGTTTTAAGGC
TATAACGCATT -> ATAACGCATTC
TATAACGTGTC -> ATAACGTGTCG
TATACAACGTC -> ATACAACGTCA
TATAGCTTACG -> ATAGCTTACGC
TATAGGACGAA -> ATAGGACGAAT
TATAGGGGAAA -> ATAGGGGAAAG
TATATATCCTA -> ATATATCCTAG
TATATCCTAGT -> ATATCCTAGTT
TATCAAAGTTC -> ATCAAAGTTCC
TATCACCACTA -> ATCACCACTAC
TATCCACCGGC -> ATCCACCGGCG
TATCCCAACGG -> ATCCCAACGGC
TATCCTAGTTT -> ATCCTAGTTTT
TATCCTATATA -> ATCCTATATAT
TATCTGTCATT -> ATCTGTCATTC
TATGACTGATT -> ATGACTGATTT
TATGATCTGGC -> ATGATCTGGCG
TATGATTAGGT -> ATGATTAGGTA
TATGCGCGTCA -> ATGCGCGTCAA
TATGCTCCGAC -> ATGCTCCGACG
TATGGCTATGT -> ATGGCTATGTC
TATGGCTGGCC -> ATGGCTGGCCA
TATGGGCATTC -> ATGGGCATTCA
TATGTCGCCCA -> ATGTCGCCCAA
TATGTTACTGA -> ATGTTACTGAC
TATTACATTTG -> ATTACATTTGC
TATTCCGGGGC -> ATTCCGGGGCC
TATTGCATCGA -> ATTGCATCGAG
TATTGCGCGCT -> ATTGCGCGCTG
TATTTCAAAAA -> ATTTCAAAAAG
TATTTCCCTGA -> ATTTCCCTGAG
TATTTTGTGTG -> ATTTTGTGTGT
TCAAAAAGACC -> CAAAAAGACCC
TCAAAGACGGT -> CAAAGACGGTA
TCAAAGTTCCA -> CAAAGTTCCAC
TCAAATATTTC -> CAAATATTTCA
TCAAATTCTAC -> CAAATTCTACT
TCAACAAGCAG -> CAACAAGCAGA
TCAACGAAGTT -> CAACGAAGTTG
TCAACGATGGT -> CAACGATGGTC
TCAACGCATAT -> CAACGCATATG
TCAAGTCATCG -> CAAGTCATCGC
TCACCACTACC -> CACCACTACCG
TCACCCGGACT -> CACCCGGACTC
TCACCGCTAGG -> CACCGCTAGGG
TCACGAACATA -> CACGAACATAG
TCACGCAGTTA -> CACGCAGTTAT
TCACGCATTGA -> CACGCATTGAA,CACGCATTGAC
TCACGTCATGA -> CACGTCATGAT
TCAGAGAGCAT -> CAGAGAGCATC
TCAGTGTCCAT -> CAGTGTCCATA
TCATAAACAGT -> CATAAACAGTC
TCATAGAAAGT -> CATAGAAAGTT
TCATCCCCCCG -> CATCCCCCCGC
TCATCGCGACA -> CATCGCGACAC
TCATCGGGTTC -> CATCGGGTTCC
TCATCGTAAAG -> CATCGTAAAGT
TCATCGTTGCT -> CATCGTTGCTT
TCATGATAGGT -> CATGATAGGTC
TCATTAATTCG -> CATTAATTCGT
TCATTCCAGTT -> CATTCCAGTTC
TCATTCTTTTA -> CATTCTTTTAG
TCATTTAGTGA -> CATTTAGTGAT
TCATTTCCATA -> CATTTCCATAA
TCCAAACGACA -> CCAAACGACAT
TCCAACGCGTG -> CCAACGCGTGC
TCCACCGGCGA -> CCACCGGCGAA
TCCACTACGGC -> CCACTACGGCA
TCCAGGACCGC -> CCAGGACCGCT
TCCAGTTAAAT -> CCAGTTAAATA
TCCAGTTCACG -> CCAGTTCACGC
TCCATAAGGAA -> CCATAAGGAAA
TCCATAATCAC -> CCATAATCACG
TCCATCAACAA -> CCATCAACAAG
TCCATGAAAAC -> CCATGAAAACA
TCCCAACGGCC -> CCCAACGGCCG
TCCCATGGTCA -> CCCATGGTCAA
TCCCCCCGCGT -> CCCCCCGCGTC
TCCCCCGTGGC -> CCCCCGTGGCG
TCCCCGAGACT -> CCCCGAGACTC
TCCCGGAGGCT -> CCCGGAGGCTG
TCCCGTTAGCG -> CCCGTTAGCGC
TCCCTGAGTAT -> CCCTGAGTATC
TCCCTGCTTAT -> CCCTGCTTATG
TCCGACGAAGT -> CCGACGAAGTT
TCCGAGGGCTC -> CCGAGGGCTCG
TCCGCGGCTGG -> CCGCGGCTGGA
TCCGCTGGCTC -> CCGCTGGCTCT
TCCGGGGCCTA -> CCGGGGCCTAG
TCCGGTTACTG -> CCGGTTACTGG
TCCGTAACAGC -> CCGTAACAGCT
TCCGTGGTGGT -> CCGTGGTGGTG
TCCTAGTTTTA -> CCTAGTTTTAA
TCCTATAGGAC -> CCTATAGGACG
TCCTATATATC -> CCTATATATCC
TCCTGTGTGCA -> CCTGTGTGCAC
TCGAACGCCAT -> CGAACGCCATG
TCGAAGATCTT -> CGAAGATCTTA
TCGACGCAGCA -> CGACGCAGCAA
TCGACTACAGG -> CGACTACAGGT
TCGAGAGTTTA -> CGAGAGTTTAT
TCGAGCACTCG -> CGAGCACTCGA
TCGAGTTTCTA -> CGAGTTTCTAA
TCGATCTTCAA -> CGATCTTCAAG
TCGATTTACAT -> CGATTTACATT
TCGCAAAGTCC -> CGCAAAGTCCC
TCGCCCAAAAT -> CGCCCAAAATC
TCGCCTTATCA -> CGCCTTATCAA
TCGCGACACAC -> CGCGACACACC
TCGCGTATGAT -> CGCGTATGATT
TCGCTATTGCG -> CGCTATTGCGC
TCGCTCAGTGT -> CGCTCAGTGTC
TCGCTGGACAC -> CGCTGGACACT
TCGCTTAAACC -> CGCTTAAACCT
TCGGACATGTT -> CGGACATGTTT
TCGGATGTGCT -> CGGATGTGCTG
TCGGCCCACCT -> CGGCCCACCTC
TCGGCTCCCCG -> CGGCTCCCCGA
TCGGGTTAATT -> CGGGTTAATTA
TCGGGTTCCGG -> CGGGTTCCGGT
TCGGTACAATG -> CGGTACAATGT
TCGGTTGTTTC -> CGGTTGTTTCG
TCGTAAAGTTA -> CGTAAAGTTAG
TCGTCATCCCC -> CGTCATCCCCC
TCGTCATTTAG -> CGTCATTTAGT
TCGTGGCAAGC -> CGTGGCAAGCC
TCGTGTAGTGG -> CGTGTAGTGGT
TCGTTGCTTGG -> CGTTGCTTGGT
TCTAAAGCTAA -> CTAAAGCTAAG
TCTAACTATGG -> CTAACTATGGG
TCTAATGAAGC -> CTAATGAAGCT
TCTACATGAAC -> CTACATGAACC
TCTACGTCGAT -> CTACGTCGATT
TCTACTTACTT -> CTACTTACTTC
TCTCAACGAAG -> CTCAACGAAGT
TCTCCAACGCG -> CTCCAACGCGT
TCTCCCCCGTG -> CTCCCCCGTGG
TCTCGAGCACT -> CTCGAGCACTC
TCTCGGTACAA -> CTCGGTACAAT
TCTCGTGGCAA -> CTCGTGGCAAG
TCTCTGCCGCG -> CTCTGCCGCGC
TCTCTTACAGA -> CTCTTACAGAG
TCTGACGGGTA -> CTGACGGGTAG
TCTGAGCTAAT -> CTGAGCTAATG
TCTGATTGGGG -> CTGATTGGGGG
TCTGCCGCGCT -> CTGCCGCGCTA
TCTGCCTGTCG -> CTGCCTGTCGA
TCTGCGGGTCG -> CTGCGGGTCGA
TCTGGCCCTCG -> CTGGCCCTCGC
TCTGGCGAGAT -> CTGGCGAGATG
TCTGGGATCTG -> CTGGGATCTGC
TCTGTCATTCT -> CTGTCATTCTT
TCTGTCGGCCC -> CTGTCGGCCCA
TCTGTGCTATT -> CTGTGCTATTG
TCTGTTTAGGT -> CTGTTTAGGTA
TCTTAACTACA -> CTTAACTACAT
TCTTACAGAGT -> CTTACAGAGTC
TCTTATCTGTC -> CTTATCTGTCA
TCTTCAAGTCA -> CTTCAAGTCAT
TCTTCCAGTTA -> CTTCCAGTTAA
TCTTCTGTCGG -> CTTCTGTCGGC
TCTTGTTATCA -> CTTGTTATCAC
TCTTTTAGACC -> CTTTTAGACCA
TGAAAACAGCG -> GAAAACAGCGA
TGAAATGCCGA -> GAAATGCCGAG
TGAACACTTAT -> GAACACTTATG
TGAACCGAAGT -> GAACCGAAGTG
TGAACGGGTTC -> GAACGGGTTCC
TGAACTGTGAA -> GAACTGTGAAT
TGAAGCAAACA -> GAAGCAAACAC
TGAAGCGGGGT -> GAAGCGGGGTT
TGAAGCTCATT -> GAAGCTCATTT
TGAATATTCCG -> GAATATTCCGG
TGAATCTGAGC -> GAATCTGAGCT
TGAATGTTCAC -> GAATGTTCACC
TGACACGAAGG -> GACACGAAGGT
TGACATCTCGT -> GACATCTCGTG
TGACCATTCAA -> GACCATTCAAC
TGACGAAAATT -> GACGAAAATTG
TGACGACCCTC -> GACGACCCTCG
TGACGCAACCC -> GACGCAACCCG
TGACGGGTAGA -> GACGGGTAGAG
TGACTGATTTG -> GACTGATTTGT
TGAGCACAAAG -> GAGCACAAAGT
TGAGCTAATGT -> GAGCTAATGTT
TGAGTATCCAC -> GAGTATCCACC
TGAGTATGACT -> GAGTATGACTG
TGATAAATAGA -> GATAAATAGAC
TGATAGGTCCC -> GATAGGTCCCG
TGATCTGGCGA -> GATCTGGCGAG
TGATTAGGTAA -> GATTAGGTAAG
TGATTGGGGGG -> GATTGGGGGGA
TGATTTAAGCG -> GATTTAAGCGC
TGATTTGTATC -> GATTTGTATCC
TGATTTGTGCT -> GATTTGTGCTG
TGCAACGTCGC -> GCAACGTCGCC
TGCACGTAATC -> GCACGTAATCA
TGCAGAGGTTC -> GCAGAGGTTCG
TGCATCGAGAG -> GCATCGAGAGT
TGCCAGGAGAG -> GCCAGGAGAGA
TGCCGAGCATA -> GCCGAGCATAC
TGCCGAGGGCC -> GCCGAGGGCCC
TGCCGCCAGGT -> GCCGCCAGGTT
TGCCGCGCTAC -> GCCGCGCTACC
TGCCTACCGCC -> GCCTACCGCCT
TGCCTGTCGAC -> GCCTGTCGACG
TGCCTTAATAC -> GCCTTAATACT
TGCGCGCTGCT -> GCGCGCTGCTG
TGCGCGTCAAA -> GCGCGTCAAAT
TGCGGGTCGAA -> GCGGGTCGAAG
TGCGTACGACT -> GCGTACGACTA
TGCTAACCACC -> GCTAACCACCC
TGCTATTGCAT -> GCTATTGCATC
TGCTCCGACGA -> GCTCCGACGAA
TGCTCTACATG -> GCTCTACATGA
TGCTCTCGGTA -> GCTCTCGGTAC
TGCTGCCAGGA -> GCTGCCAGGAG
TGCTGGATAGT -> GCTGGATAGTC
TGCTGTGTCGC -> GCTGTGTCGCT
TGCTTATGCGC -> GCTTATGCGCG
TGCTTGGTCTA -> GCTTGGTCTAA
TGGAATTTTTC -> GGAATTTTTCT
TGGACACTCAT -> GGACACTCATA
TGGACAGCGTC -> GGACAGCGTCT
TGGATAGTCTG -> GGATAGTCTGA
TGGATCTCTTA -> GGATCTCTTAC
TGGCAAGCCGG -> GGCAAGCCGGG
TGGCCAACGAC -> GGCCAACGACG
TGGCCCTCGCA -> GGCCCTCGCAA
TGGCGAGATGA -> GGCGAGATGAA
TGGCGATCTCT -> GGCGATCTCTG
TGGCTATGTCG -> GGCTATGTCGC
TGGCTCTGGGA -> GGCTCTGGGAT
TGGCTGAGCAC -> GGCTGAGCACA
TGGCTGGCCAA -> GGCTGGCCAAC
TGGCTTTAGAC -> GGCTTTAGACT
TGGGAGGTCCA -> GGGAGGTCCAT
TGGGATCTGCG -> GGGATCTGCGG
TGGGCATTCAA -> GGGCATTCAAA
TGGGCGGAGAC -> GGGCGGAGACA
TGGGGGGAACA -> GGGGGGAACAA
TGGGGTCTGTG -> GGGGTCTGTGC
TGGTAGATCCC -> GGTAGATCCCT
TGGTAGTGAAG -> GGTAGTGAAGC
TGGTCAACGAT -> GGTCAACGATG
TGGTCCAAACG -> GGTCCAAACGA
TGGTCTAACTA -> GGTCTAACTAT
TGGTGGTGTTG -> GGTGGTGTTGG
TGGTGTAGGTG -> GGTGTAGGTGA
TGGTGTTGGTG -> GGTGTTGGTGT
TGGTTGAACAC -> GGTTGAACACT
TGGTTGTCGAG -> GGTTGTCGAGT
TGTACCGTAAC -> GTACCGTAACC
TGTAGGTGAAT -> GTAGGTGAATC
TGTAGTGGTTG -> GTAGTGGTTGA
TGTATCCTATA -> GTATCCTATAT
TGTATGATCTG -> GTATGATCTGG
TGTCATCGGGT -> GTCATCGGGTT
TGTCATTCTTT -> GTCATTCTTTT
TGTCCATAATC -> GTCCATAATCA
TGTCGACGCAG -> GTCGACGCAGC
TGTCGAGTTTC -> GTCGAGTTTCT
TGTCGCCCAAA -> GTCGCCCAAAA
TGTCGCTTAAA -> GTCGCTTAAAC
TGTCGGCCCAC -> GTCGGCCCACC
TGTCGGTTGTT -> GTCGGTTGTTT
TGTCTTCCAGT -> GTCTTCCAGTT
TGTGAATATTC -> GTGAATATTCC
TGTGACGACCC -> GTGACGACCCT
TGTGCACGTAA -> GTGCACGTAAT
TGTGCTATTGC -> GTGCTATTGCA
TGTGCTGGATA -> GTGCTGGATAG
TGTGCTGTGTC -> GTGCTGTGTCG
TGTGTACCGTA -> GTGTACCGTAA
TGTGTCATCGG -> GTGTCATCGGG
TGTGTCGCTTA -> GTGTCGCTTAA
TGTGTGCACGT -> GTGTGCACGTA
TGTGTGTCATC -> GTGTGTCATCG
TGTTACTGACA -> GTTACTGACAC
TGTTAGACCAA -> GTTAGACCAAA
TGTTATCACCA -> GTTATCACCAC
TGTTCACCGCT -> GTTCACCGCTA
TGTTGAACTGT -> GTTGAACTGTG
TGTTGGACAGC -> GTTGGACAGCG
TGTTGGTGTAG -> GTTGGTGTAGG
TGTTTAACTCC -> GTTTAACTCCC
TGTTTAGGTAA -> GTTTAGGTAAA
TGTTTATGCTC -> GTTTATGCTCC
TGTTTCGGATG -> GTTTCGGATGT
TTAAACCTAAG -> TAAACCTAAGA
TTAAATATCCC -> TAAATATCCCA
TTAACGAGAAA -> TAACGAGAAAA
TTAACTACATG -> TAACTACATGC
TTAACTCCCAT -> TAACTCCCATG
TTAACTGGCTT -> TAACTGGCTTT
TTAAGCGCTGA -> TAAGCGCTGAA
TTAAGGCCTGT -> TAAGGCCTGTT
TTAATACTTGT -> TAATACTTGTG
TTAATTAGGTA -> TAATTAGGTAC
TTAATTCGTCA -> TAATTCGTCAT
TTACAGAGTCT -> TACAGAGTCTT
TTACATTGGTA -> TACATTGGTAG
TTACATTTGCC -> TACATTTGCCG
TTACCTGCTCT -> TACCTGCTCTA
TTACCTTCTTG -> TACCTTCTTGT
TTACGATTGCT -> TACGATTGCTA
TTACGCGATTA -> TACGCGATTAT
TTACTATAGCT -> TACTATAGCTT
TTACTGACACG -> TACTGACACGA
TTACTGGTTGT -> TACTGGTTGTC
TTACTTCACCC -> TACTTCACCCG
TTAGACCAAAG -> TAGACCAAAGG
TTAGACCACGG -> TAGACCACGGT
TTAGACTAGGG -> TAGACTAGGGG
TTAGCGCAGTC -> TAGCGCAGTCC
TTAGCTTGCCG -> TAGCTTGCCGC
TTAGGTAAAGT -> TAGGTAAAGTT
TTAGGTAAGGC -> TAGGTAAGGCT
TTAGGTACTCA -> TAGGTACTCAA
TTAGTGATAAA -> TAGTGATAAAT
TTATAACGCAT -> TATAACGCATT
TTATAACGTGT -> TATAACGTGTC
TTATAGGGGAA -> TATAGGGGAAA
TTATCAAAGTT -> TATCAAAGTTC
TTATCACCACT -> TATCACCACTA
TTATCTGTCAT -> TATCTGTCATT
TTATGCGCGTC -> TATGCGCGTCA
TTATGCTCCGA -> TATGCTCCGAC
TTATGGCTGGC -> TATGGCTGGCC
TTATGTTACTG -> TATGTTACTGA
TTATTACATTT -> TATTACATTTG
TTATTTCCCTG -> TATTTCCCTGA
TTATTTTGTGT -> TATTTTGTGTG
TTCAAAAAGAC -> TCAAAAAGACC
TTCAAAGACGG -> TCAAAGACGGT
TTCAACGCATA -> TCAACGCATAT
TTCAAGTCATC -> TCAAGTCATCG
TTCACCCGGAC -> TCACCCGGACT
TTCACCGCTAG -> TCACCGCTAGG
TTCACGCATTG -> TCACGCATTGA
TTCCACTACGG -> TCCACTACGGC
TTCCAGGACCG -> TCCAGGACCGC
TTCCAGTTAAA -> TCCAGTTAAAT
TTCCAGTTCAC -> TCCAGTTCACG
TTCCATAAGGA -> TCCATAAGGAA
TTCCCTGAGTA -> TCCCTGAGTAT
TTCCGCGGCTG -> TCCGCGGCTGG
TTCCGGGGCCT -> TCCGGGGCCTA
TTCCGGTTACT -> TCCGGTTACTG
TTCCGTAACAG -> TCCGTAACAGC
TTCGCTCAGTG -> TCGCTCAGTGT
TTCGGATGTGC -> TCGGATGTGCT
TTCGTCATTTA -> TCGTCATTTAG
TTCTAAAGCTA -> TCTAAAGCTAA
TTCTACGTCGA -> TCTACGTCGAT
TTCTACTTACT -> TCTACTTACTT
TTCTCAACGAA -> TCTCAACGAAG
TTCTCCAACGC -> TCTCCAACGCG
TTCTGATTGGG -> TCTGATTGGGG
TTCTGGCCCTC -> TCTGGCCCTCG
TTCTGTCGGCC -> TCTGTCGGCCC
TTCTTAACTAC -> TCTTAACTACA
TTCTTGTTATC -> TCTTGTTATCA
TTCTTTTAGAC -> TCTTTTAGACC
TTGAACACTTA -> TGAACACTTAT
TTGAACGGGTT -> TGAACGGGTTC
TTGAACTGTGA -> TGAACTGTGAA
TTGACCATTCA -> TGACCATTCAA
TTGCAACGTCG -> TGCAACGTCGC
TTGCATCGAGA -> TGCATCGAGAG
TTGCCGAGCAT -> TGCCGAGCATA
TTGCCGCCAGG -> TGCCGCCAGGT
TTGCGCGCTGC -> TGCGCGCTGCT
TTGCTAACCAC -> TGCTAACCACC
TTGCTTGGTCT -> TGCTTGGTCTA
TTGGACAGCGT -> TGGACAGCGTC
TTGGATCTCTT -> TGGATCTCTTA
TTGGCTGAGCA -> TGGCTGAGCAC
TTGGGAGGTCC -> TGGGAGGTCCA
TTGGGGGGAAC -> TGGGGGGAACA
TTGGTAGATCC -> TGGTAGATCCC
TTGGTCTAACT -> TGGTCTAACTA
TTGGTGTAGGT -> TGGTGTAGGTG
TTGTATCCTAT -> TGTATCCTATA
TTGTCGAGTTT -> TGTCGAGTTTC
TTGTCTTCCAG -> TGTCTTCCAGT
TTGTGACGACC -> TGTGACGACCC
TTGTGCTGTGT -> TGTGCTGTGTC
TTGTGTGTCAT -> TGTGTGTCATC
TTGTTATCACC -> TGTTATCACCA
TTGTTTCGGAT -> TGTTTCGGATG
TTTAACTCCCA -> TTAACTCCCAT
TTTAACTGGCT -> TTAACTGGCTT
TTTAAGCGCTG -> TTAAGCGCTGA
TTTAAGGCCTG -> TTAAGGCCTGT
TTTACATTGGT -> TTACATTGGTA
TTTACCTGCTC -> TTACCTGCTCT
TTTACCTTCTT -> TTACCTTCTTG
TTTAGACCACG -> TTAGACCACGG
TTTAGACTAGG -> TTAGACTAGGG
TTTAGGTAAAG -> TTAGGTAAAGT
TTTAGTGATAA -> TTAGTGATAAA
TTTATAACGCA -> TTATAACGCAT
TTTATGCTCCG -> TTATGCTCCGA
TTTCAAAAAGA -> TTCAAAAAGAC
TTTCCATAAGG -> TTCCATAAGGA
TTTCCCTGAGT -> TTCCCTGAGTA
TTTCCGCGGCT -> TTCCGCGGCTG
TTTCGGATGTG -> TTCGGATGTGC
TTTCTAAAGCT -> TTCTAAAGCTA
TTTCTACGTCG -> TTCTACGTCGA
TTTGCCGAGCA -> TTGCCGAGCAT
TTTGGCTGAGC -> TTGGCTGAGCA
TTTGTATCCTA -> TTGTATCCTAT
TTTGTCTTCCA -> TTGTCTTCCAG
TTTGTGCTGTG -> TTGTGCTGTGT
TTTGTGTGTCA -> TTGTGTGTCAT
TTTTAAGGCCT -> TTTAAGGCCTG
TTTTACCTGCT -> TTTACCTGCTC
TTTTAGACCAC -> TTTAGACCACG
TTTTCTACGTC -> TTTCTACGTCG
TTTTGTGTGTC -> TTTGTGTGTCA
TTTTTCTACGT -> TTTTCTACGTC