30 100
CCCAGCCCACCACAGGGTGAGTTAGGTTTT|GGACGAAAGGGACAGATAGAGACGGACGAA
AAGTTCCACCAGCTGGAGACAGACACTGGA|AACATTTCACCTGTGGGGTGATTGCCCTTC
GACTTGATTCACCGAAATCAAGTTCCACCA|TCCCCGTTAGGAATCTGGAAACATTTCACC
TGATTACACTAGCACATGACGTGCACTCAA|AAAGGGACAGACTTGATTACGGACGAAAGG
GATTGGTTACAACGTACTCGGTCTGTAGAG|CTAGCTCGGTTCCTCCCTGCAGTGATGAGC
CTCAAGTTAGAGACGTAGAGACGGACGAAA|AAAGGGACAGACTTGATTCAGCCACGATAT
TGAGCACGCCTAGAGACGGACGAAAGGGAC|ACAGCGGACTGCTAGAGACGGACGAAAGGG
TTATTAGAGACGGACGAAAGGGACAGACTT|AGCTAGTCCAAATAGAGACGGACGAAAGGG
CGGATGCGTACTATTAGGACAGACCCCAAG|CTATTTGACGAAGTAGGGGACACACACTCG
AGCTGGAGACAGACACTGGAGCATTTCATC|CTGTGGGGTGATTGCCCTTCGGCCGCGGAC
AGACTTGATTGGTTACAACGTACTCGGTCT|CACAAGCTAGCTCGGTTCCTCCCTGCAGTG
GTTCTCAATAACGTCTTATAACAGACGCTT|ACTCTCGATCCGATCAATAGAGACGGACGA
ACTTGATTTTAGATGCCTTATTTGCGAGGT|CCACCAGCTGGAGACAGACACTGGAGCATT
ACGAAAGGGACAGACTTGATTGGTTACAAC|TGAGGGGTTGGCACAAGCTAGCTCGGTTCC
CTGTAACTTCTCGACCTAGCCCCGCACACG|ACTTGATTCTTGATTATCTAGTTGCGTACT
AAGTAGGGGACACACACTCGTTCTCAATAA|TAATTGCCCAGAAAGTCGGACTCTCGATCC
ATAACTCTTCCCCGTTAGGAATCTGGAAAC|GAACCGATTAACTACGACCAGCTGTAAGTC
TGTTACTAACTGTAACTTCTCGACCTAGCC|AAGGGACAGACTTGATTCTTGATTATCTAG
ATTCTTATAACTCTTCCCCGTTAGGAATCT|GAGGCGGAACCGATTAACTACGACCAGCTG
GCCTTATTTGCGAGGTGAGGTGCCGTTCAT|CAGACACTGGAGCATTTCATCACGAGCCCG
CGCCATCAAGCTAGTCCAAATAGAGACGGA|GTAGGCATGAGTTCAGTCGTATGGTGAATA
AACGTACTCGGTCTGTAGAGTAGAGACGGA|TCCTCCCTGCAGTGATGAGCACGCCTAGAG
ATTAGGACAGACCCCAAGACATTCAAGTCT|GTAGGGGACACACACTCGTTCTCAATAACG
TTGATTACACTAGCACATGACGTGCACTCA|GAAAGGGACAGACTTGATTACGGACGAAAG
AGTCCAAATAGAGACGGACGAAAGGGACAG|TCAGTCGTATGGTGAATATGCGTACGCTCG
GAAAGGGACAGACTTGATTACGGACGAAAG|CGGACGAAAGGGACAGACTTGATTAACTTA
CACAGGGTGAGTTAGGTTTTGTTACTAACT|GACAGATAGAGACGGACGAAAGGGACAGAC
CGAAAGGGACAGACTTGATTCTTGATTATC|GACTATGTGGCATTTAATAGCGAAGCTTAT
CGGACGAAAGGGACAGACTTGATTAACTTA|GACGGACGAAAGGGACAGACTTGATTGACA
TCACCTGTGGGGTGATTGCCCTTCGGCCGC|AGTAGCTGTACGTGTATACCGCGGGATTCG
AGGCATGAGTTCAGTCGTATGGTGAATATG|TGCTGTCGATCGCGGATGGGAAACGTTTGT
GAACAGTGTCTAGAGACGGACGAAAGGGAC|TAACAGACGCTTAATTTAAGGTCCGCTTTC
AGAGACGGACGAAAGGGACAGACTTGATTA|CTAGAGACGGACGAAAGGGACAGACTTGAT
AACAGACGCTTAATTTAAGGTCCGCTTTCA|GAGACGGACGAAAGGGACAGACTTGATAGA
ATTTCATCACGAGCCCGCCATCAAGCTAGT|CCGCGGACTAGGCTCGTAGGCATGAGTTCA
GGACAGACTTGATTTTAGATGCCTTATTTG|CAAGTTCCACCAGCTGGAGACAGACACTGG
GAGACGGACGAAAGGGACAGATAGAGACGG|AATTTAAGGTCCGCTTTCACATAAAATTGG
ACTTGATTCACCGAAATCAAGTTCCACCAG|CCCCGTTAGGAATCTGGAAACATTTCACCT
GCATGAGTTCAGTCGTATGGTGAATATGCG|CTGTCGATCGCGGATGGGAAACGTTTGTAC
CGGACGAAAGGGACAGACTTGATTTTAGAG|AATAGAGACGGACGAAAGGGACAGACTTGA
TCCAAATAGAGACGGACGAAAGGGACAGAC|AGTCGTATGGTGAATATGCGTACGCTCGGC
TCCCTGCGGCAACAGAAGCACTCGGCCGAT|GACAGACCCCAAGACATTCAAGTCTCGATT
CGAGCCCGCCATCAAGCTAGTCCAAATAGA|AGGCTCGTAGGCATGAGTTCAGTCGTATGG
AGAGACGGACGAAAGGGACAGACTTGATTA|CGCCTAGAGACGGACGAAAGGGACAGACTT
GACGGACGAAAGGGACAGACTTGATTGTGT|CGGCAACAGAAGCACTCGGCCGATCTGGGT
ATTTCACCTGTGGGGTGATTGCCCTTCGGC|TGGAGTAGCTGTACGTGTATACCGCGGGAT
GACGTAGAGACGGACGAAAGGGACAGACTT|CTTGATTCAGCCACGATATCTCTAGGCAGC
GCCGATCTGGGTATCCCGTTTGTCCCAGCC|TCGATTGAACAGTGTCTAGAGACGGACGAA
GACAGACTTGATTACACTAGCACATGACGT|GACGGACGAAAGGGACAGACTTGATTACGG
CTTGATTCTTGATTATCTAGTTGCGTACTA|TTAATAGCGAAGCTTATTTGAGATCAGTCG
GGGACAGACTTGATTGACGAAAGGGACAGA|CTCTAGGCAGCAAACATGAGGGGTTGGCAC
CATCACGAGCCCGCCATCAAGCTAGTCCAA|GGACTAGGCTCGTAGGCATGAGTTCAGTCG
CTAGAGACGGACGAAAGGGACAGACTTGAT|TGCTAGAGACGGACGAAAGGGACAGACTTG
GGTGATTGCCCTTCGGCCGCGGACTAGGCT|CGTGTATACCGCGGGATTCGAAGCCCGGGT
TAACTCTTCCCCGTTAGGAATCTGGAAACA|AACCGATTAACTACGACCAGCTGTAAGTCT
AGCTAGTCCAAATAGAGACGGACGAAAGGG|GAGTTCAGTCGTATGGTGAATATGCGTACG
ATCAAGTTCCACCAGCTGGAGACAGACACT|GGAAACATTTCACCTGTGGGGTGATTGCCC
GTTGGCACAAGCTAGCTCGGTTCCTCCCTG|TTGATTGTGTAGATCTTGGTAGATCGCAAC
TGATGAGCACGCCTAGAGACGGACGAAAGG|GAGACAGCGGACTGCTAGAGACGGACGAAA
GACCTAGCCCCGCACACGGATGCGTACTAT|ATTATCTAGTTGCGTACTATTTGACGAAGT
AATCAAGTTCCACCAGCTGGAGACAGACAC|TGGAAACATTTCACCTGTGGGGTGATTGCC
CAGTCGTCCAGGTTAATTGCCCAGAAAGTC|AGGTGCCGTTCATCTGAGTTTATTAGAGAC
TGGAGAATCCCTGCGGCAACAGAAGCACTC|CTATTAGGACAGACCCCAAGACATTCAAGT
GAAAGGGACAGACTTGATAGAGACGGACGA|CGGACGAAAGGGACAGACTTGATTCACCGA
GACGGACGAAAGGGACAGACTTGATTCACC|ATTATTCTTATAACTCTTCCCCGTTAGGAA
GCCCACCACAGGGTGAGTTAGGTTTTGTTA|GAAAGGGACAGATAGAGACGGACGAAAGGG
TCTTGATTATCTAGTTGCGTACTATTTGAC|GCGAAGCTTATTTGAGATCAGTCGTCCAGG
TTGTTACTAACTGTAACTTCTCGACCTAGC|AAAGGGACAGACTTGATTCTTGATTATCTA
TCAATCAAGGTCTGATACTCACAATCTTCT|AGGGACAGACTTGATTGGTTACAACGTACT
CGCTTAATTTAAGGTCCGCTTTCACATAAA|GACGAAAGGGACAGACTTGATAGAGACGGA
GCATTTAATAGCGAAGCTTATTTGAGATCA|TGATTTTAGATGCCTTATTTGCGAGGTGAG
TCCGCTTTCACATAAAATTGGAGACTATGT|ACTTGATAGAGACGGACGAAAGGGACAGAC
GAGACGTAGAGACGGACGAAAGGGACAGAC|GACTTGATTCAGCCACGATATCTCTAGGCA
TTAGATGCCTTATTTGCGAGGTGAGGTGCC|TGGAGACAGACACTGGAGCATTTCATCACG
AACGACGAGACAGCGGACTGCTAGAGACGG|CCACCACAGGGTGAGTTAGGTTTTGTTACT
ACGTACTCGGTCTGTAGAGTAGAGACGGAC|CCTCCCTGCAGTGATGAGCACGCCTAGAGA
CATGAGGGGTTGGCACAAGCTAGCTCGGTT|GGACAGACTTGATTGTGTAGATCTTGGTAG
AAGCTAGCTCGGTTCCTCCCTGCAGTGATG|GTAGATCTTGGTAGATCGCAACGACGAGAC
TCCCAGCCCACCACAGGGTGAGTTAGGTTT|CGGACGAAAGGGACAGATAGAGACGGACGA
GCTAGAGACGGACGAAAGGGACAGACTTGA|GTTTTGTTACTAACTGTAACTTCTCGACCT
TGTGTAGATCTTGGTAGATCGCAACGACGA|TGGGTATCCCGTTTGTCCCAGCCCACCACA
AGATCGCAACGACGAGACAGCGGACTGCTA|TCCCAGCCCACCACAGGGTGAGTTAGGTTT
GACGAAAGGGACAGACTTGATTCAGCCACG|TTAACTTATTCGTAAGCGTCTCCGTCTTAA
CTCTCGATCCGATCAATAGAGACGGACGAA|CGAAAGGGACAGACTTGATTTTAGAGACGG
ACTTGATTACGGACGAAAGGGACAGACTTG|GACAGACTTGATTAACTTATTCGTAAGCGT
TTTAGATGCCTTATTTGCGAGGTGAGGTGC|CTGGAGACAGACACTGGAGCATTTCATCAC
ACGCTTAATTTAAGGTCCGCTTTCACATAA|GGACGAAAGGGACAGACTTGATAGAGACGG
GACGAAAGGGACAGACTTGATTACGGACGA|AGACGGACGAAAGGGACAGACTTGATTAAC
AAACATGAGGGGTTGGCACAAGCTAGCTCG|AAGGGACAGACTTGATTGTGTAGATCTTGG
CTTAAACTAGAGACGGACGAAAGGGACAGA|GAGAATCCCTGCGGCAACAGAAGCACTCGG
TCGGTTCCTCCCTGCAGTGATGAGCACGCC|TGGTAGATCGCAACGACGAGACAGCGGACT
ACAGACTTGATTAACTTATTCGTAAGCGTC|GGACAGACTTGATTGACAGTGTAATGGTGA
GAGACGGACGAAAGGGACAGACTTGATTTT|TGATTCACCGAAATCAAGTTCCACCAGCTG
ACAGACTTGATTACACTAGCACATGACGTG|ACGGACGAAAGGGACAGACTTGATTACGGA
AGCTTATTTGAGATCAGTCGTCCAGGTTAA|TTATTTGCGAGGTGAGGTGCCGTTCATCTG
TCTAGGCAGCAAACATGAGGGGTTGGCACA|AGACGGACGAAAGGGACAGACTTGATTGTG
TATCTCTAGGCAGCAAACATGAGGGGTTGG|CTAGAGACGGACGAAAGGGACAGACTTGAT
TTAGGAATCTGGAAACATTTCACCTGTGGG|CGACCAGCTGTAAGTCTGGAGTAGCTGTAC
CACACACTCGTTCTCAATAACGTCTTATAA|GAAAGTCGGACTCTCGATCCGATCAATAGA
CTATGTGGCATTTAATAGCGAAGCTTATTT|ACAGACTTGATTTTAGATGCCTTATTTGCG
CTGATACTCACAATCTTCTAGAGACGGACG|TGATTGGTTACAACGTACTCGGTCTGTAGA
GACAGTGTAATGGTGAGTATGGAGAATCCC|CCCCGCACACGGATGCGTACTATTAGGACA
ACGAGACAGCGGACTGCTAGAGACGGACGA|CACAGGGTGAGTTAGGTTTTGTTACTAACT
GAATCTGGAAACATTTCACCTGTGGGGTGA|CAGCTGTAAGTCTGGAGTAGCTGTACGTGT
AAAGGGACAGACTTGATTGTGTAGATCTTG|GAAGCACTCGGCCGATCTGGGTATCCCGTT
AAAATTGGAGACTATGTGGCATTTAATAGC|GGACGAAAGGGACAGACTTGATTTTAGATG
CAGACTTGATTGTGTAGATCTTGGTAGATC|TCGGCCGATCTGGGTATCCCGTTTGTCCCA
ATCAAGCTAGTCCAAATAGAGACGGACGAA|GCATGAGTTCAGTCGTATGGTGAATATGCG
ACGGACGAAAGGGACAGATAGAGACGGACG|TTAAGGTCCGCTTTCACATAAAATTGGAGA
GGTGAGGTGCCGTTCATCTGAGTTTATTAG|ATTTCATCACGAGCCCGCCATCAAGCTAGT
AGCATTTCATCACGAGCCCGCCATCAAGCT|CGGCCGCGGACTAGGCTCGTAGGCATGAGT
ACTAACTGTAACTTCTCGACCTAGCCCCGC|GACAGACTTGATTCTTGATTATCTAGTTGC
AGACGGACGAAAGGGACAGACTTGATTGTG|GCGGCAACAGAAGCACTCGGCCGATCTGGG
CTCAATCAAGGTCTGATACTCACAATCTTC|AAGGGACAGACTTGATTGGTTACAACGTAC
AGACTTGATTATTCTTATAACTCTTCCCCG|CGGCCCTACCGAGGCGGAACCGATTAACTA
AGACTTGATTCTTGATTATCTAGTTGCGTA|CATTTAATAGCGAAGCTTATTTGAGATCAG
AGAGTAGAGACGGACGAAAGGGACAGACTT|GAGCACGCCTAGAGACGGACGAAAGGGACA
ATTGTGTAGATCTTGGTAGATCGCAACGAC|TCTGGGTATCCCGTTTGTCCCAGCCCACCA
CAAGTCTCGATTGAACAGTGTCTAGAGACG|AATAACGTCTTATAACAGACGCTTAATTTA
TAGCCCCGCACACGGATGCGTACTATTAGG|TCTAGTTGCGTACTATTTGACGAAGTAGGG
TCTAGTTGCGTACTATTTGACGAAGTAGGG|ATTTGAGATCAGTCGTCCAGGTTAATTGCC
GGACGAAAGGGACAGACTTGATAGAGACGG|GAGACGGACGAAAGGGACAGACTTGATTCA
GGACAGACTTGATTCTTGATTATCTAGTTG|GTGGCATTTAATAGCGAAGCTTATTTGAGA
TGATTGACGAAAGGGACAGACTTGATTGGT|CAAACATGAGGGGTTGGCACAAGCTAGCTC
GCACTCAAGTTAGAGACGTAGAGACGGACG|ACGAAAGGGACAGACTTGATTCAGCCACGA
AAGGGACAGACTTGATTAACTTATTCGTAA|GAAAGGGACAGACTTGATTGACAGTGTAAT
CGTAGAGACGGACGAAAGGGACAGACTTGA|TGATTCAGCCACGATATCTCTAGGCAGCAA
AAATTGGAGACTATGTGGCATTTAATAGCG|GACGAAAGGGACAGACTTGATTTTAGATGC
CTCACAATCTTCTAGAGACGGACGAAAGGG|GTTACAACGTACTCGGTCTGTAGAGTAGAG
TCACCGAAATCAAGTTCCACCAGCTGGAGA|AGGAATCTGGAAACATTTCACCTGTGGGGT
TTCATCACGAGCCCGCCATCAAGCTAGTCC|GCGGACTAGGCTCGTAGGCATGAGTTCAGT
AGGGTGAGTTAGGTTTTGTTACTAACTGTA|AGATAGAGACGGACGAAAGGGACAGACTTG
AGACGGACGAAAGGGACAGATAGAGACGGA|ATTTAAGGTCCGCTTTCACATAAAATTGGA
CCCCGTTAGGAATCTGGAAACATTTCACCT|AACTACGACCAGCTGTAAGTCTGGAGTAGC
AGTTCCACCAGCTGGAGACAGACACTGGAG|ACATTTCACCTGTGGGGTGATTGCCCTTCG
CAAGCTAGTCCAAATAGAGACGGACGAAAG|ATGAGTTCAGTCGTATGGTGAATATGCGTA
AATTGCCCAGAAAGTCGGACTCTCGATCCG|TGAGTTTATTAGAGACGGACGAAAGGGACA
ACGAAAGGGACAGACTTGATTTTAGAGACG|AGAGACGGACGAAAGGGACAGACTTGATTA
TAGCTCGGTTCCTCCCTGCAGTGATGAGCA|ATCTTGGTAGATCGCAACGACGAGACAGCG
GGAGACAGACACTGGAGCATTTCATCACGA|GGGGTGATTGCCCTTCGGCCGCGGACTAGG
CAGTGTCTAGAGACGGACGAAAGGGACAGA|CAGACGCTTAATTTAAGGTCCGCTTTCACA
GACAGACTTGATTACGGACGAAAGGGACAG|AAAGGGACAGACTTGATTAACTTATTCGTA
ATTATCTAGTTGCGTACTATTTGACGAAGT|GCTTATTTGAGATCAGTCGTCCAGGTTAAT
ACTTGATTTTAGAGACGGACGAAAGGGACA|AGGGACAGACTTGATTATTCTTATAACTCT
AACATGAGGGGTTGGCACAAGCTAGCTCGG|AGGGACAGACTTGATTGTGTAGATCTTGGT
AAAGGGACAGACTTGATTGGTTACAACGTA|GGGGTTGGCACAAGCTAGCTCGGTTCCTCC
ATCAAGGTCTGATACTCACAATCTTCTAGA|GACAGACTTGATTGGTTACAACGTACTCGG
TCAATAACGTCTTATAACAGACGCTTAATT|TCGATCCGATCAATAGAGACGGACGAAAGG
TTACAACGTACTCGGTCTGTAGAGTAGAGA|CGGTTCCTCCCTGCAGTGATGAGCACGCCT
CTGCTAGAGACGGACGAAAGGGACAGACTT|AGGTTTTGTTACTAACTGTAACTTCTCGAC
GGACAGACTTGATTGACGAAAGGGACAGAC|TCTAGGCAGCAAACATGAGGGGTTGGCACA
GATTGAACAGTGTCTAGAGACGGACGAAAG|CTTATAACAGACGCTTAATTTAAGGTCCGC
CCCGTTAGGAATCTGGAAACATTTCACCTG|ACTACGACCAGCTGTAAGTCTGGAGTAGCT
GCGAAGCTTATTTGAGATCAGTCGTCCAGG|TGCCTTATTTGCGAGGTGAGGTGCCGTTCA
TATTTGACGAAGTAGGGGACACACACTCGT|CGTCCAGGTTAATTGCCCAGAAAGTCGGAC
AGAGACGGACGAAAGGGACAGACTTGATTG|CTGCGGCAACAGAAGCACTCGGCCGATCTG
AGTTGCGTACTATTTGACGAAGTAGGGGAC|TGAGATCAGTCGTCCAGGTTAATTGCCCAG
GACGGACGAAAGGGACAGACTTGATTGACA|TTACTAACTGTAACTTCTCGACCTAGCCCC
CCAGCTGGAGACAGACACTGGAGCATTTCA|ACCTGTGGGGTGATTGCCCTTCGGCCGCGG
ATCTAGTTGCGTACTATTTGACGAAGTAGG|TATTTGAGATCAGTCGTCCAGGTTAATTGC
TCATCACGAGCCCGCCATCAAGCTAGTCCA|CGGACTAGGCTCGTAGGCATGAGTTCAGTC
ACAGACTTGATTGTGTAGATCTTGGTAGAT|CTCGGCCGATCTGGGTATCCCGTTTGTCCC
TTTCACCTGTGGGGTGATTGCCCTTCGGCC|GGAGTAGCTGTACGTGTATACCGCGGGATT
GTGAGTATGGAGAATCCCTGCGGCAACAGA|ATGCGTACTATTAGGACAGACCCCAAGACA
ACAGACTTGATTACGGACGAAAGGGACAGA|AAGGGACAGACTTGATTAACTTATTCGTAA
AGGGACAGACTTGATTGACAGTGTAATGGT|TAACTTCTCGACCTAGCCCCGCACACGGAT
TGCAGTGATGAGCACGCCTAGAGACGGACG|ACGACGAGACAGCGGACTGCTAGAGACGGA
TGATTCACCGAAATCAAGTTCCACCAGCTG|CGTTAGGAATCTGGAAACATTTCACCTGTG
ATAAAATTGGAGACTATGTGGCATTTAATA|ACGGACGAAAGGGACAGACTTGATTTTAGA
AATTGGAGACTATGTGGCATTTAATAGCGA|ACGAAAGGGACAGACTTGATTTTAGATGCC
TTGATTATTCTTATAACTCTTCCCCGTTAG|CCTACCGAGGCGGAACCGATTAACTACGAC
GACGAAAGGGACAGACTTGATTCTTGATTA|GAGACTATGTGGCATTTAATAGCGAAGCTT
AGTTAGGTTTTGTTACTAACTGTAACTTCT|AGACGGACGAAAGGGACAGACTTGATTCTT
CTTGATTACACTAGCACATGACGTGCACTC|CGAAAGGGACAGACTTGATTACGGACGAAA
GGGACAGACTTGATTACACTAGCACATGAC|GAGACGGACGAAAGGGACAGACTTGATTAC
GTTACTAACTGTAACTTCTCGACCTAGCCC|AGGGACAGACTTGATTCTTGATTATCTAGT
AGGGACAGACTTGATTTTAGATGCCTTATT|ATCAAGTTCCACCAGCTGGAGACAGACACT
ACGGACGAAAGGGACAGACTTGATTGTGTA|GGCAACAGAAGCACTCGGCCGATCTGGGTA
ACTTGATTAACTTATTCGTAAGCGTCTCCG|AGACTTGATTGACAGTGTAATGGTGAGTAT
GGTGAGTATGGAGAATCCCTGCGGCAACAG|GATGCGTACTATTAGGACAGACCCCAAGAC
TCGATTGAACAGTGTCTAGAGACGGACGAA|GTCTTATAACAGACGCTTAATTTAAGGTCC
GTGATGAGCACGCCTAGAGACGGACGAAAG|CGAGACAGCGGACTGCTAGAGACGGACGAA
ATCGCAACGACGAGACAGCGGACTGCTAGA|CCAGCCCACCACAGGGTGAGTTAGGTTTTG
ATAGAGACGGACGAAAGGGACAGACTTGAT|ACTTGATTCACCGAAATCAAGTTCCACCAG
ACTTGATTGTGTAGATCTTGGTAGATCGCA|GCCGATCTGGGTATCCCGTTTGTCCCAGCC
ACAGACTTGATTTTAGAGACGGACGAAAGG|CGAAAGGGACAGACTTGATTATTCTTATAA
TTTGCGAGGTGAGGTGCCGTTCATCTGAGT|CTGGAGCATTTCATCACGAGCCCGCCATCA
CCCGCCATCAAGCTAGTCCAAATAGAGACG|TCGTAGGCATGAGTTCAGTCGTATGGTGAA
GACCCCAAGACATTCAAGTCTCGATTGAAC|ACACACTCGTTCTCAATAACGTCTTATAAC
TTTCACATAAAATTGGAGACTATGTGGCAT|ATAGAGACGGACGAAAGGGACAGACTTGAT
GATTGACAGTGTAATGGTGAGTATGGAGAA|CTAGCCCCGCACACGGATGCGTACTATTAG
ACAGACTTGATTATTCTTATAACTCTTCCC|CTCGGCCCTACCGAGGCGGAACCGATTAAC
TAGAGACGGACGAAAGGGACAGATAGAGAC|TTAATTTAAGGTCCGCTTTCACATAAAATT
TAGAGACGGACGAAAGGGACAGACTTGATT|ACGCCTAGAGACGGACGAAAGGGACAGACT
GATTCTTGATTATCTAGTTGCGTACTATTT|ATAGCGAAGCTTATTTGAGATCAGTCGTCC
AACAGAAGCACTCGGCCGATCTGGGTATCC|AAGACATTCAAGTCTCGATTGAACAGTGTC
GGACAGACTTGATTCAGCCACGATATCTCT|TTCGTAAGCGTCTCCGTCTTAAACTAGAGA
AATAGAGACGGACGAAAGGGACAGACTTGA|GTATGGTGAATATGCGTACGCTCGGCCCTA
GGACAGACTTGATTGACAGTGTAATGGTGA|ACTTCTCGACCTAGCCCCGCACACGGATGC
ACGGATGCGTACTATTAGGACAGACCCCAA|ACTATTTGACGAAGTAGGGGACACACACTC
GACGAAAGGGACAGACTTGATTTTAGATGC|ACCGAAATCAAGTTCCACCAGCTGGAGACA
AGATCAGTCGTCCAGGTTAATTGCCCAGAA|GGTGAGGTGCCGTTCATCTGAGTTTATTAG
GGAAACATTTCACCTGTGGGGTGATTGCCC|TAAGTCTGGAGTAGCTGTACGTGTATACCG
GACTATGTGGCATTTAATAGCGAAGCTTAT|GGACAGACTTGATTTTAGATGCCTTATTTG
CTCTAGGCAGCAAACATGAGGGGTTGGCAC|GAGACGGACGAAAGGGACAGACTTGATTGT
GAAAGGGACAGACTTGATTTTAGATGCCTT|GAAATCAAGTTCCACCAGCTGGAGACAGAC
GGTGAGTTAGGTTTTGTTACTAACTGTAAC|ATAGAGACGGACGAAAGGGACAGACTTGAT
GGACGAAAGGGACAGACTTGATTACACTAG|GTAGAGTAGAGACGGACGAAAGGGACAGAC
ATGAGGGGTTGGCACAAGCTAGCTCGGTTC|GACAGACTTGATTGTGTAGATCTTGGTAGA
GATCTTGGTAGATCGCAACGACGAGACAGC|TCCCGTTTGTCCCAGCCCACCACAGGGTGA
CCCGCACACGGATGCGTACTATTAGGACAG|GTTGCGTACTATTTGACGAAGTAGGGGACA
GGCATTTAATAGCGAAGCTTATTTGAGATC|TTGATTTTAGATGCCTTATTTGCGAGGTGA
GATGCGTACTATTAGGACAGACCCCAAGAC|ATTTGACGAAGTAGGGGACACACACTCGTT
GACGGACGAAAGGGACAGACTTGATTTTAG|ATTCACCGAAATCAAGTTCCACCAGCTGGA
ACACGGATGCGTACTATTAGGACAGACCCC|GTACTATTTGACGAAGTAGGGGACACACAC
ACAGTGTAATGGTGAGTATGGAGAATCCCT|CCCGCACACGGATGCGTACTATTAGGACAG
AACTGTAACTTCTCGACCTAGCCCCGCACA|AGACTTGATTCTTGATTATCTAGTTGCGTA
ACGTCTTATAACAGACGCTTAATTTAAGGT|CGATCAATAGAGACGGACGAAAGGGACAGA
GTTCATCTGAGTTTATTAGAGACGGACGAA|AGCCCGCCATCAAGCTAGTCCAAATAGAGA
CCGATCTGGGTATCCCGTTTGTCCCAGCCC|CGATTGAACAGTGTCTAGAGACGGACGAAA
GTAATGGTGAGTATGGAGAATCCCTGCGGC|ACACGGATGCGTACTATTAGGACAGACCCC
CCTGCAGTGATGAGCACGCCTAGAGACGGA|CAACGACGAGACAGCGGACTGCTAGAGACG
ACTAGGCTCGTAGGCATGAGTTCAGTCGTA|GCCCGGGTTAGTGCTGTCGATCGCGGATGG
TTCTTGATTATCTAGTTGCGTACTATTTGA|AGCGAAGCTTATTTGAGATCAGTCGTCCAG
AGAGACGGACGAAAGGGACAGACTTGATTC|TTGATTATTCTTATAACTCTTCCCCGTTAG
CGAAAGGGACAGACTTGATTGACGAAAGGG|GATATCTCTAGGCAGCAAACATGAGGGGTT
AGACAGCGGACTGCTAGAGACGGACGAAAG|AGGGTGAGTTAGGTTTTGTTACTAACTGTA
TAGAGACGGACGAAAGGGACAGACTTGATT|CTTGATTCACCGAAATCAAGTTCCACCAGC
GCGGACTAGGCTCGTAGGCATGAGTTCAGT|CGAAGCCCGGGTTAGTGCTGTCGATCGCGG
ATCCGATCAATAGAGACGGACGAAAGGGAC|GGACAGACTTGATTTTAGAGACGGACGAAA
GACGGACGAAAGGGACAGACTTGATTAACT|GAGACGGACGAAAGGGACAGACTTGATTGA
GATTTTAGATGCCTTATTTGCGAGGTGAGG|CAGCTGGAGACAGACACTGGAGCATTTCAT
CACCTGTGGGGTGATTGCCCTTCGGCCGCG|GTAGCTGTACGTGTATACCGCGGGATTCGA
ACGAGCCCGCCATCAAGCTAGTCCAAATAG|TAGGCTCGTAGGCATGAGTTCAGTCGTATG
TAATTGCCCAGAAAGTCGGACTCTCGATCC|CTGAGTTTATTAGAGACGGACGAAAGGGAC
AGACTTGATTGACGAAAGGGACAGACTTGA|GGCAGCAAACATGAGGGGTTGGCACAAGCT
TAGGCATGAGTTCAGTCGTATGGTGAATAT|GTGCTGTCGATCGCGGATGGGAAACGTTTG
GGCATGAGTTCAGTCGTATGGTGAATATGC|GCTGTCGATCGCGGATGGGAAACGTTTGTA
AAGGGACAGACTTGATTGGTTACAACGTAC|GGGTTGGCACAAGCTAGCTCGGTTCCTCCC
TCCCTGCAGTGATGAGCACGCCTAGAGACG|CGCAACGACGAGACAGCGGACTGCTAGAGA
TACTAACTGTAACTTCTCGACCTAGCCCCG|GGACAGACTTGATTCTTGATTATCTAGTTG
TCGGCCGATCTGGGTATCCCGTTTGTCCCA|GTCTCGATTGAACAGTGTCTAGAGACGGAC
GGGACAGACTTGATTGGTTACAACGTACTC|GTTGGCACAAGCTAGCTCGGTTCCTCCCTG
TAGATGCCTTATTTGCGAGGTGAGGTGCCG|GGAGACAGACACTGGAGCATTTCATCACGA
CGAAAGGGACAGACTTGATAGAGACGGACG|ACGGACGAAAGGGACAGACTTGATTCACCG
GATTGCCCTTCGGCCGCGGACTAGGCTCGT|GTATACCGCGGGATTCGAAGCCCGGGTTAG
GGACACACACTCGTTCTCAATAACGTCTTA|CCAGAAAGTCGGACTCTCGATCCGATCAAT
TCTTAAACTAGAGACGGACGAAAGGGACAG|GGAGAATCCCTGCGGCAACAGAAGCACTCG
TGCCTTATTTGCGAGGTGAGGTGCCGTTCA|ACAGACACTGGAGCATTTCATCACGAGCCC
AGCCCCGCACACGGATGCGTACTATTAGGA|CTAGTTGCGTACTATTTGACGAAGTAGGGG
CAGCGGACTGCTAGAGACGGACGAAAGGGA|GTGAGTTAGGTTTTGTTACTAACTGTAACT
CACGCCTAGAGACGGACGAAAGGGACAGAC|CGGACTGCTAGAGACGGACGAAAGGGACAG
ATTAACTTATTCGTAAGCGTCTCCGTCTTA|TGATTGACAGTGTAATGGTGAGTATGGAGA
CACGAGCCCGCCATCAAGCTAGTCCAAATA|CTAGGCTCGTAGGCATGAGTTCAGTCGTAT
GTGTCTAGAGACGGACGAAAGGGACAGATA|GACGCTTAATTTAAGGTCCGCTTTCACATA
CTTAATTTAAGGTCCGCTTTCACATAAAAT|CGAAAGGGACAGACTTGATAGAGACGGACG
CTCCCTGCAGTGATGAGCACGCCTAGAGAC|TCGCAACGACGAGACAGCGGACTGCTAGAG
TCCGTCTTAAACTAGAGACGGACGAAAGGG|GTATGGAGAATCCCTGCGGCAACAGAAGCA
TAGAGACGGACGAAAGGGACAGACTTGATT|GCTAGAGACGGACGAAAGGGACAGACTTGA
CCACCAGCTGGAGACAGACACTGGAGCATT|TTCACCTGTGGGGTGATTGCCCTTCGGCCG
AAAGGGACAGACTTGATTGACGAAAGGGAC|TATCTCTAGGCAGCAAACATGAGGGGTTGG
AGACGGACGAAAGGGACAGACTTGATTATT|GTGAATATGCGTACGCTCGGCCCTACCGAG
TTACTAACTGTAACTTCTCGACCTAGCCCC|GGGACAGACTTGATTCTTGATTATCTAGTT
GGGACAGATAGAGACGGACGAAAGGGACAG|CTTTCACATAAAATTGGAGACTATGTGGCA
GCCCAGAAAGTCGGACTCTCGATCCGATCA|TTTATTAGAGACGGACGAAAGGGACAGACT
TTATTCGTAAGCGTCTCCGTCTTAAACTAG|ACAGTGTAATGGTGAGTATGGAGAATCCCT
TAGGCAGCAAACATGAGGGGTTGGCACAAG|ACGGACGAAAGGGACAGACTTGATTGTGTA
TGTGGGGTGATTGCCCTTCGGCCGCGGACT|CTGTACGTGTATACCGCGGGATTCGAAGCC
ACCCCAAGACATTCAAGTCTCGATTGAACA|CACACTCGTTCTCAATAACGTCTTATAACA
AAGGTCTGATACTCACAATCTTCTAGAGAC|AGACTTGATTGGTTACAACGTACTCGGTCT
CAGACTTGATTGACAGTGTAATGGTGAGTA|TCTCGACCTAGCCCCGCACACGGATGCGTA
GGGACAGACTTGATTTTAGATGCCTTATTT|TCAAGTTCCACCAGCTGGAGACAGACACTG
ACATGACGTGCACTCAAGTTAGAGACGTAG|TGATTACGGACGAAAGGGACAGACTTGATT
GAAAGGGACAGACTTGATTGTGTAGATCTT|AGAAGCACTCGGCCGATCTGGGTATCCCGT
CACCGAAATCAAGTTCCACCAGCTGGAGAC|GGAATCTGGAAACATTTCACCTGTGGGGTG
AGAGACGGACGAAAGGGACAGACTTGATTA|CGGTCTGTAGAGTAGAGACGGACGAAAGGG
TTGCCCAGAAAGTCGGACTCTCGATCCGAT|AGTTTATTAGAGACGGACGAAAGGGACAGA
AAATCAAGTTCCACCAGCTGGAGACAGACA|CTGGAAACATTTCACCTGTGGGGTGATTGC
AGACTTGATTACGGACGAAAGGGACAGACT|GGGACAGACTTGATTAACTTATTCGTAAGC
GGTCCGCTTTCACATAAAATTGGAGACTAT|AGACTTGATAGAGACGGACGAAAGGGACAG
TTGATTATCTAGTTGCGTACTATTTGACGA|GAAGCTTATTTGAGATCAGTCGTCCAGGTT
TTAGAGACGTAGAGACGGACGAAAGGGACA|ACAGACTTGATTCAGCCACGATATCTCTAG
GAGGTGCCGTTCATCTGAGTTTATTAGAGA|TCATCACGAGCCCGCCATCAAGCTAGTCCA
TAATTTAAGGTCCGCTTTCACATAAAATTG|AAAGGGACAGACTTGATAGAGACGGACGAA
GACAGACTTGATTTTAGAGACGGACGAAAG|ACGAAAGGGACAGACTTGATTATTCTTATA
CGGACGAAAGGGACAGACTTGATTGACGAA|CCACGATATCTCTAGGCAGCAAACATGAGG
AGACTTGATTAACTTATTCGTAAGCGTCTC|ACAGACTTGATTGACAGTGTAATGGTGAGT
CGCACACGGATGCGTACTATTAGGACAGAC|TGCGTACTATTTGACGAAGTAGGGGACACA
GAAAGGGACAGACTTGATTCAGCCACGATA|ACTTATTCGTAAGCGTCTCCGTCTTAAACT
CTTATTTGCGAGGTGAGGTGCCGTTCATCT|GACACTGGAGCATTTCATCACGAGCCCGCC
CGGACGAAAGGGACAGATAGAGACGGACGA|TAAGGTCCGCTTTCACATAAAATTGGAGAC
AGGGCCCCTCACTCAATCAAGGTCTGATAC|TTGATTGACGAAAGGGACAGACTTGATTGG
ACTTATTCGTAAGCGTCTCCGTCTTAAACT|TGACAGTGTAATGGTGAGTATGGAGAATCC
TAGAGACGGACGAAAGGGACAGACTTGATT|CCTGCGGCAACAGAAGCACTCGGCCGATCT
ACAGACTTGATAGAGACGGACGAAAGGGAC|AAGGGACAGACTTGATTCACCGAAATCAAG
ATCTTCTAGAGACGGACGAAAGGGACAGAC|ACGTACTCGGTCTGTAGAGTAGAGACGGAC
ATGAGCACGCCTAGAGACGGACGAAAGGGA|GACAGCGGACTGCTAGAGACGGACGAAAGG
GACAGACTTGATTGGTTACAACGTACTCGG|TGGCACAAGCTAGCTCGGTTCCTCCCTGCA
GAGACGGACGAAAGGGACAGACTTGATTGA|TGTTACTAACTGTAACTTCTCGACCTAGCC
ACGGACGAAAGGGACAGACTTGATAGAGAC|TAGAGACGGACGAAAGGGACAGACTTGATT
CGTACTCGGTCTGTAGAGTAGAGACGGACG|CTCCCTGCAGTGATGAGCACGCCTAGAGAC
GATTCACCGAAATCAAGTTCCACCAGCTGG|GTTAGGAATCTGGAAACATTTCACCTGTGG
ATCTTGGTAGATCGCAACGACGAGACAGCG|CCCGTTTGTCCCAGCCCACCACAGGGTGAG
CTAGAGACGGACGAAAGGGACAGACTTGAT|TTTTGTTACTAACTGTAACTTCTCGACCTA
TGGAGCATTTCATCACGAGCCCGCCATCAA|CTTCGGCCGCGGACTAGGCTCGTAGGCATG
AGAGACGGACGAAAGGGACAGACTTGATTC|AAAATTGGAGACTATGTGGCATTTAATAGC
GAAAGGGACAGACTTGATTATTCTTATAAC|GCGTACGCTCGGCCCTACCGAGGCGGAACC
AACGTCTTATAACAGACGCTTAATTTAAGG|CCGATCAATAGAGACGGACGAAAGGGACAG
GGTTACAACGTACTCGGTCTGTAGAGTAGA|CTCGGTTCCTCCCTGCAGTGATGAGCACGC
CGGACTGCTAGAGACGGACGAAAGGGACAG|AGTTAGGTTTTGTTACTAACTGTAACTTCT
TCGTAAGCGTCTCCGTCTTAAACTAGAGAC|TGTAATGGTGAGTATGGAGAATCCCTGCGG
GACTTGATTGACAGTGTAATGGTGAGTATG|TCGACCTAGCCCCGCACACGGATGCGTACT
TCTGATACTCACAATCTTCTAGAGACGGAC|TTGATTGGTTACAACGTACTCGGTCTGTAG
ACTTGATAGAGACGGACGAAAGGGACAGAC|GACAGACTTGATTCACCGAAATCAAGTTCC
TCTTATAACTCTTCCCCGTTAGGAATCTGG|GGCGGAACCGATTAACTACGACCAGCTGTA
AGCGTCTCCGTCTTAAACTAGAGACGGACG|TGGTGAGTATGGAGAATCCCTGCGGCAACA
AGGGACAGACTTGATTCTTGATTATCTAGT|ATGTGGCATTTAATAGCGAAGCTTATTTGA
AATAGAGACGGACGAAAGGGACAGACTTGA|TTGATTTTAGAGACGGACGAAAGGGACAGA
TCCACCAGCTGGAGACAGACACTGGAGCAT|TTTCACCTGTGGGGTGATTGCCCTTCGGCC
GAGCACGCCTAGAGACGGACGAAAGGGACA|CAGCGGACTGCTAGAGACGGACGAAAGGGA
GGTATCCCGTTTGTCCCAGCCCACCACAGG|CAGTGTCTAGAGACGGACGAAAGGGACAGA
CTCAATAACGTCTTATAACAGACGCTTAAT|CTCGATCCGATCAATAGAGACGGACGAAAG
GAAAGGGACAGACTTGATTTTAGAGACGGA|AGACGGACGAAAGGGACAGACTTGATTATT
TCACAATCTTCTAGAGACGGACGAAAGGGA|TTACAACGTACTCGGTCTGTAGAGTAGAGA
TGAGATCAGTCGTCCAGGTTAATTGCCCAG|GAGGTGAGGTGCCGTTCATCTGAGTTTATT
AGCACTCGGCCGATCTGGGTATCCCGTTTG|TTCAAGTCTCGATTGAACAGTGTCTAGAGA
GGGACAGACTTGATTGACAGTGTAATGGTG|AACTTCTCGACCTAGCCCCGCACACGGATG
CATTTCATCACGAGCCCGCCATCAAGCTAG|GCCGCGGACTAGGCTCGTAGGCATGAGTTC
CGAGACAGCGGACTGCTAGAGACGGACGAA|ACAGGGTGAGTTAGGTTTTGTTACTAACTG
TTTGTCCCAGCCCACCACAGGGTGAGTTAG|GAGACGGACGAAAGGGACAGATAGAGACGG
AGACGGACGAAAGGGACAGACTTGATTGAC|CAGCCACGATATCTCTAGGCAGCAAACATG
CTCCGTCTTAAACTAGAGACGGACGAAAGG|AGTATGGAGAATCCCTGCGGCAACAGAAGC
AGACGCTTAATTTAAGGTCCGCTTTCACAT|ACGGACGAAAGGGACAGACTTGATAGAGAC
CTAGTCCAAATAGAGACGGACGAAAGGGAC|GTTCAGTCGTATGGTGAATATGCGTACGCT
TTAACTTATTCGTAAGCGTCTCCGTCTTAA|GATTGACAGTGTAATGGTGAGTATGGAGAA
GACGCTTAATTTAAGGTCCGCTTTCACATA|CGGACGAAAGGGACAGACTTGATAGAGACG
ACGAAAGGGACAGACTTGATTTTAGATGCC|CCGAAATCAAGTTCCACCAGCTGGAGACAG
GAGCATTTCATCACGAGCCCGCCATCAAGC|TCGGCCGCGGACTAGGCTCGTAGGCATGAG
GGACTGCTAGAGACGGACGAAAGGGACAGA|GTTAGGTTTTGTTACTAACTGTAACTTCTC
ACAGAAGCACTCGGCCGATCTGGGTATCCC|AGACATTCAAGTCTCGATTGAACAGTGTCT
ACAGACTTGATTGGTTACAACGTACTCGGT|GGCACAAGCTAGCTCGGTTCCTCCCTGCAG
TGATTACGGACGAAAGGGACAGACTTGATT|AGACTTGATTAACTTATTCGTAAGCGTCTC
CGGACGAAAGGGACAGACTTGATTCTTGAT|TGGAGACTATGTGGCATTTAATAGCGAAGC
ACGGACGAAAGGGACAGACTTGATTACACT|CTGTAGAGTAGAGACGGACGAAAGGGACAG
TAACGTCTTATAACAGACGCTTAATTTAAG|TCCGATCAATAGAGACGGACGAAAGGGACA
GCAAACATGAGGGGTTGGCACAAGCTAGCT|GAAAGGGACAGACTTGATTGTGTAGATCTT
GTAAGCGTCTCCGTCTTAAACTAGAGACGG|TAATGGTGAGTATGGAGAATCCCTGCGGCA
CAACAGAAGCACTCGGCCGATCTGGGTATC|CAAGACATTCAAGTCTCGATTGAACAGTGT
GGGACAGACTTGATTAACTTATTCGTAAGC|AAGGGACAGACTTGATTGACAGTGTAATGG
AACAGTGTCTAGAGACGGACGAAAGGGACA|AACAGACGCTTAATTTAAGGTCCGCTTTCA
AAGGTCCGCTTTCACATAAAATTGGAGACT|ACAGACTTGATAGAGACGGACGAAAGGGAC
ACAGACTTGATTCAGCCACGATATCTCTAG|CGTAAGCGTCTCCGTCTTAAACTAGAGACG
AGATAGAGACGGACGAAAGGGACAGACTTG|ACATAAAATTGGAGACTATGTGGCATTTAA
CTTGGTAGATCGCAACGACGAGACAGCGGA|CGTTTGTCCCAGCCCACCACAGGGTGAGTT
GACGAAAGGGACAGACTTGATTGGTTACAA|ATGAGGGGTTGGCACAAGCTAGCTCGGTTC
AGACGGACGAAAGGGACAGACTTGATTCTT|AATTGGAGACTATGTGGCATTTAATAGCGA
ATGCGTACTATTAGGACAGACCCCAAGACA|TTTGACGAAGTAGGGGACACACACTCGTTC
GTTGCGTACTATTTGACGAAGTAGGGGACA|GAGATCAGTCGTCCAGGTTAATTGCCCAGA
CTGTAGAGTAGAGACGGACGAAAGGGACAG|TGATGAGCACGCCTAGAGACGGACGAAAGG
AGAGACGGACGAAAGGGACAGACTTGATTG|TTGTTACTAACTGTAACTTCTCGACCTAGC
AAAGGGACAGATAGAGACGGACGAAAGGGA|CCGCTTTCACATAAAATTGGAGACTATGTG
TTCAAGTCTCGATTGAACAGTGTCTAGAGA|TCAATAACGTCTTATAACAGACGCTTAATT
GACGAAAGGGACAGACTTGATTTTAGAGAC|TAGAGACGGACGAAAGGGACAGACTTGATT
GACATTCAAGTCTCGATTGAACAGTGTCTA|GTTCTCAATAACGTCTTATAACAGACGCTT
CCATCAAGCTAGTCCAAATAGAGACGGACG|AGGCATGAGTTCAGTCGTATGGTGAATATG
ACCAGCTGGAGACAGACACTGGAGCATTTC|CACCTGTGGGGTGATTGCCCTTCGGCCGCG
GAAAGGGACAGACTTGATTCTTGATTATCT|ACTATGTGGCATTTAATAGCGAAGCTTATT
CACTCGGCCGATCTGGGTATCCCGTTTGTC|CAAGTCTCGATTGAACAGTGTCTAGAGACG
CCTTCGGCCGCGGACTAGGCTCGTAGGCAT|CGCGGGATTCGAAGCCCGGGTTAGTGCTGT
GACTTGATTTTAGATGCCTTATTTGCGAGG|TCCACCAGCTGGAGACAGACACTGGAGCAT
GATAGAGACGGACGAAAGGGACAGACTTGA|GACTTGATTCACCGAAATCAAGTTCCACCA
GGACAGACTTGATTACGGACGAAAGGGACA|GAAAGGGACAGACTTGATTAACTTATTCGT
TTAATTTAAGGTCCGCTTTCACATAAAATT|GAAAGGGACAGACTTGATAGAGACGGACGA
GATCAGTCGTCCAGGTTAATTGCCCAGAAA|GTGAGGTGCCGTTCATCTGAGTTTATTAGA
CGTAGGCATGAGTTCAGTCGTATGGTGAAT|TAGTGCTGTCGATCGCGGATGGGAAACGTT
TGATTATTCTTATAACTCTTCCCCGTTAGG|CTACCGAGGCGGAACCGATTAACTACGACC
GTCTCCGTCTTAAACTAGAGACGGACGAAA|TGAGTATGGAGAATCCCTGCGGCAACAGAA
GACGAAAGGGACAGACTTGATTCACCGAAA|TTCTTATAACTCTTCCCCGTTAGGAATCTG
CACGATATCTCTAGGCAGCAAACATGAGGG|TTAAACTAGAGACGGACGAAAGGGACAGAC
CGGACGAAAGGGACAGACTTGATTGACAGT|ACTAACTGTAACTTCTCGACCTAGCCCCGC
AGGGGTTGGCACAAGCTAGCTCGGTTCCTC|AGACTTGATTGTGTAGATCTTGGTAGATCG
GGGACAGACTTGATTGTGTAGATCTTGGTA|GCACTCGGCCGATCTGGGTATCCCGTTTGT
TTAGGACAGACCCCAAGACATTCAAGTCTC|TAGGGGACACACACTCGTTCTCAATAACGT
GCTCGTAGGCATGAGTTCAGTCGTATGGTG|GGTTAGTGCTGTCGATCGCGGATGGGAAAC
AAGGGACAGACTTGATAGAGACGGACGAAA|GACGAAAGGGACAGACTTGATTCACCGAAA
TCAAGTTCCACCAGCTGGAGACAGACACTG|GAAACATTTCACCTGTGGGGTGATTGCCCT
AATAACGTCTTATAACAGACGCTTAATTTA|GATCCGATCAATAGAGACGGACGAAAGGGA
TTGAACAGTGTCTAGAGACGGACGAAAGGG|TATAACAGACGCTTAATTTAAGGTCCGCTT
CGTACTATTAGGACAGACCCCAAGACATTC|GACGAAGTAGGGGACACACACTCGTTCTCA
TTAATTGCCCAGAAAGTCGGACTCTCGATC|TCTGAGTTTATTAGAGACGGACGAAAGGGA
GTACTATTAGGACAGACCCCAAGACATTCA|ACGAAGTAGGGGACACACACTCGTTCTCAA
TGAGTATGGAGAATCCCTGCGGCAACAGAA|TGCGTACTATTAGGACAGACCCCAAGACAT
CCCTGCAGTGATGAGCACGCCTAGAGACGG|GCAACGACGAGACAGCGGACTGCTAGAGAC
GGACAGACTTGATTCACCGAAATCAAGTTC|ACTCTTCCCCGTTAGGAATCTGGAAACATT
CGTTAGGAATCTGGAAACATTTCACCTGTG|TACGACCAGCTGTAAGTCTGGAGTAGCTGT
CTGGAGCATTTCATCACGAGCCCGCCATCA|CCTTCGGCCGCGGACTAGGCTCGTAGGCAT
TTCAGCCACGATATCTCTAGGCAGCAAACA|TCCGTCTTAAACTAGAGACGGACGAAAGGG
CGGACGAAAGGGACAGACTTGATTACGGAC|AGAGACGGACGAAAGGGACAGACTTGATTA
CTTGATTCACCGAAATCAAGTTCCACCAGC|CCCGTTAGGAATCTGGAAACATTTCACCTG
ACATAAAATTGGAGACTATGTGGCATTTAA|AGACGGACGAAAGGGACAGACTTGATTTTA
TCTTGGTAGATCGCAACGACGAGACAGCGG|CCGTTTGTCCCAGCCCACCACAGGGTGAGT
TAGAGTAGAGACGGACGAAAGGGACAGACT|TGAGCACGCCTAGAGACGGACGAAAGGGAC
AGCCCGCCATCAAGCTAGTCCAAATAGAGA|GCTCGTAGGCATGAGTTCAGTCGTATGGTG
GCTCGGTTCCTCCCTGCAGTGATGAGCACG|CTTGGTAGATCGCAACGACGAGACAGCGGA
AGGAATCTGGAAACATTTCACCTGTGGGGT|ACCAGCTGTAAGTCTGGAGTAGCTGTACGT
ATCTGAGTTTATTAGAGACGGACGAAAGGG|CGCCATCAAGCTAGTCCAAATAGAGACGGA
GATTGTGTAGATCTTGGTAGATCGCAACGA|ATCTGGGTATCCCGTTTGTCCCAGCCCACC
AACTAGAGACGGACGAAAGGGACAGACTTG|ATCCCTGCGGCAACAGAAGCACTCGGCCGA
ACGAAAGGGACAGACTTGATTCTTGATTAT|AGACTATGTGGCATTTAATAGCGAAGCTTA
ACGTAGAGACGGACGAAAGGGACAGACTTG|TTGATTCAGCCACGATATCTCTAGGCAGCA
GGACAGACCCCAAGACATTCAAGTCTCGAT|GGGACACACACTCGTTCTCAATAACGTCTT
GGACAGACTTGATTATTCTTATAACTCTTC|CGCTCGGCCCTACCGAGGCGGAACCGATTA
TGGTGAGTATGGAGAATCCCTGCGGCAACA|GGATGCGTACTATTAGGACAGACCCCAAGA
TTATAACAGACGCTTAATTTAAGGTCCGCT|AATAGAGACGGACGAAAGGGACAGACTTGA
TTCCTCCCTGCAGTGATGAGCACGCCTAGA|AGATCGCAACGACGAGACAGCGGACTGCTA
CGAAAGGGACAGACTTGATTGTGTAGATCT|CAGAAGCACTCGGCCGATCTGGGTATCCCG
CCGCACACGGATGCGTACTATTAGGACAGA|TTGCGTACTATTTGACGAAGTAGGGGACAC
CCGTAGGGCCCCTCACTCAATCAAGGTCTG|AGACTTGATTGACGAAAGGGACAGACTTGA
TTTAAGGTCCGCTTTCACATAAAATTGGAG|GGGACAGACTTGATAGAGACGGACGAAAGG
ACTCACAATCTTCTAGAGACGGACGAAAGG|GGTTACAACGTACTCGGTCTGTAGAGTAGA
ATTTTAGATGCCTTATTTGCGAGGTGAGGT|AGCTGGAGACAGACACTGGAGCATTTCATC
GCGTACTATTAGGACAGACCCCAAGACATT|TGACGAAGTAGGGGACACACACTCGTTCTC
GCCCCTCACTCAATCAAGGTCTGATACTCA|ATTGACGAAAGGGACAGACTTGATTGGTTA
GCCCCGCACACGGATGCGTACTATTAGGAC|TAGTTGCGTACTATTTGACGAAGTAGGGGA
AGCACATGACGTGCACTCAAGTTAGAGACG|ACTTGATTACGGACGAAAGGGACAGACTTG
TATCTAGTTGCGTACTATTTGACGAAGTAG|TTATTTGAGATCAGTCGTCCAGGTTAATTG
GGACGAAAGGGACAGACTTGATTCACCGAA|ATTCTTATAACTCTTCCCCGTTAGGAATCT
GAAATCAAGTTCCACCAGCTGGAGACAGAC|TCTGGAAACATTTCACCTGTGGGGTGATTG
GGACGAAAGGGACAGACTTGATTGACGAAA|CACGATATCTCTAGGCAGCAAACATGAGGG
GGGTATCCCGTTTGTCCCAGCCCACCACAG|ACAGTGTCTAGAGACGGACGAAAGGGACAG
AGTTAGAGACGTAGAGACGGACGAAAGGGA|GGACAGACTTGATTCAGCCACGATATCTCT
GAAAGGGACAGACTTGATTCACCGAAATCA|TTATAACTCTTCCCCGTTAGGAATCTGGAA
GTCTCGATTGAACAGTGTCTAGAGACGGAC|AACGTCTTATAACAGACGCTTAATTTAAGG
AGGTTAATTGCCCAGAAAGTCGGACTCTCG|TCATCTGAGTTTATTAGAGACGGACGAAAG
AAGGGACAGACTTGATTCTTGATTATCTAG|TATGTGGCATTTAATAGCGAAGCTTATTTG
GGACGAAAGGGACAGATAGAGACGGACGAA|AAGGTCCGCTTTCACATAAAATTGGAGACT
TATAACTCTTCCCCGTTAGGAATCTGGAAA|GGAACCGATTAACTACGACCAGCTGTAAGT
CGAAAGGGACAGACTTGATTACACTAGCAC|GAGTAGAGACGGACGAAAGGGACAGACTTG
ACTCAATCAAGGTCTGATACTCACAATCTT|AAAGGGACAGACTTGATTGGTTACAACGTA
CTAGAGACGGACGAAAGGGACAGATAGAGA|CTTAATTTAAGGTCCGCTTTCACATAAAAT
TCCGATCAATAGAGACGGACGAAAGGGACA|GACAGACTTGATTTTAGAGACGGACGAAAG
GACGAAAGGGACAGATAGAGACGGACGAAA|AGGTCCGCTTTCACATAAAATTGGAGACTA
TCTAGAGACGGACGAAAGGGACAGACTTGA|ACTCGGTCTGTAGAGTAGAGACGGACGAAA
GAGACGGACGAAAGGGACAGACTTGATTAA|TAGAGACGGACGAAAGGGACAGACTTGATT
GTAACTTCTCGACCTAGCCCCGCACACGGA|TTGATTCTTGATTATCTAGTTGCGTACTAT
GTAGGCATGAGTTCAGTCGTATGGTGAATA|AGTGCTGTCGATCGCGGATGGGAAACGTTT
TATCCCGTTTGTCCCAGCCCACCACAGGGT|GTGTCTAGAGACGGACGAAAGGGACAGATA
CCTGCGGCAACAGAAGCACTCGGCCGATCT|CAGACCCCAAGACATTCAAGTCTCGATTGA
ACTTGATTCTTGATTATCTAGTTGCGTACT|TTTAATAGCGAAGCTTATTTGAGATCAGTC
GAAAGGGACAGACTTGATTAACTTATTCGT|ACGAAAGGGACAGACTTGATTGACAGTGTA
ATTAGAGACGGACGAAAGGGACAGACTTGA|CTAGTCCAAATAGAGACGGACGAAAGGGAC
AGACGGACGAAAGGGACAGACTTGATAGAG|TTTAGAGACGGACGAAAGGGACAGACTTGA
TTTAATAGCGAAGCTTATTTGAGATCAGTC|TTTTAGATGCCTTATTTGCGAGGTGAGGTG
GATTATCTAGTTGCGTACTATTTGACGAAG|AGCTTATTTGAGATCAGTCGTCCAGGTTAA
GTTAGAGACGTAGAGACGGACGAAAGGGAC|GACAGACTTGATTCAGCCACGATATCTCTA
ACTTGATTGACGAAAGGGACAGACTTGATT|CAGCAAACATGAGGGGTTGGCACAAGCTAG
GTTCCACCAGCTGGAGACAGACACTGGAGC|CATTTCACCTGTGGGGTGATTGCCCTTCGG
TGCCCTTCGGCCGCGGACTAGGCTCGTAGG|TACCGCGGGATTCGAAGCCCGGGTTAGTGC
CGGACGAAAGGGACAGACTTGATTCAGCCA|GATTAACTTATTCGTAAGCGTCTCCGTCTT
CCCAGAAAGTCGGACTCTCGATCCGATCAA|TTATTAGAGACGGACGAAAGGGACAGACTT
CGGACGAAAGGGACAGACTTGATTACACTA|TGTAGAGTAGAGACGGACGAAAGGGACAGA
AGACTTGATTACACTAGCACATGACGTGCA|GGACGAAAGGGACAGACTTGATTACGGACG
TGATTTTAGATGCCTTATTTGCGAGGTGAG|CCAGCTGGAGACAGACACTGGAGCATTTCA
AGTAGAGACGGACGAAAGGGACAGACTTGA|GCACGCCTAGAGACGGACGAAAGGGACAGA
GGACGAAAGGGACAGACTTGATTCTTGATT|GGAGACTATGTGGCATTTAATAGCGAAGCT
CCGCGGACTAGGCTCGTAGGCATGAGTTCA|TTCGAAGCCCGGGTTAGTGCTGTCGATCGC
ACTTGATTGACAGTGTAATGGTGAGTATGG|CGACCTAGCCCCGCACACGGATGCGTACTA
GGACGAAAGGGACAGACTTGATTGTGTAGA|CAACAGAAGCACTCGGCCGATCTGGGTATC
CACAATCTTCTAGAGACGGACGAAAGGGAC|TACAACGTACTCGGTCTGTAGAGTAGAGAC
CTTGATTTTAGAGACGGACGAAAGGGACAG|GGGACAGACTTGATTATTCTTATAACTCTT
CTGCAGTGATGAGCACGCCTAGAGACGGAC|AACGACGAGACAGCGGACTGCTAGAGACGG
AAAGGGACAGACTTGATTAACTTATTCGTA|CGAAAGGGACAGACTTGATTGACAGTGTAA
TCTCGACCTAGCCCCGCACACGGATGCGTA|CTTGATTATCTAGTTGCGTACTATTTGACG
GTAGATCGCAACGACGAGACAGCGGACTGC|TGTCCCAGCCCACCACAGGGTGAGTTAGGT
CGGCAACAGAAGCACTCGGCCGATCTGGGT|CCCCAAGACATTCAAGTCTCGATTGAACAG
CGTCCAGGTTAATTGCCCAGAAAGTCGGAC|GCCGTTCATCTGAGTTTATTAGAGACGGAC
TACGGACGAAAGGGACAGACTTGATTCAGC|TTGATTAACTTATTCGTAAGCGTCTCCGTC
ATCAATAGAGACGGACGAAAGGGACAGACT|GACTTGATTTTAGAGACGGACGAAAGGGAC
ATGGTGAGTATGGAGAATCCCTGCGGCAAC|CGGATGCGTACTATTAGGACAGACCCCAAG
TGTAGATCTTGGTAGATCGCAACGACGAGA|GGTATCCCGTTTGTCCCAGCCCACCACAGG
GTTTATTAGAGACGGACGAAAGGGACAGAC|CAAGCTAGTCCAAATAGAGACGGACGAAAG
CTCGTAGGCATGAGTTCAGTCGTATGGTGA|GTTAGTGCTGTCGATCGCGGATGGGAAACG
CCGATCAATAGAGACGGACGAAAGGGACAG|ACAGACTTGATTTTAGAGACGGACGAAAGG
TGACGTGCACTCAAGTTAGAGACGTAGAGA|TTACGGACGAAAGGGACAGACTTGATTCAG
TTCTCAATAACGTCTTATAACAGACGCTTA|CTCTCGATCCGATCAATAGAGACGGACGAA
AGACTTGATTTTAGATGCCTTATTTGCGAG|TTCCACCAGCTGGAGACAGACACTGGAGCA
ACAAGCTAGCTCGGTTCCTCCCTGCAGTGA|GTGTAGATCTTGGTAGATCGCAACGACGAG
TAGAGACGGACGAAAGGGACAGACTTGATT|ATGGTGAATATGCGTACGCTCGGCCCTACC
TGGTAGATCGCAACGACGAGACAGCGGACT|TTTGTCCCAGCCCACCACAGGGTGAGTTAG
ATAGAGACGGACGAAAGGGACAGACTTGAT|TATGGTGAATATGCGTACGCTCGGCCCTAC
ACGAAAGGGACAGACTTGATAGAGACGGAC|GACGGACGAAAGGGACAGACTTGATTCACC
CCTTATTTGCGAGGTGAGGTGCCGTTCATC|AGACACTGGAGCATTTCATCACGAGCCCGC
AAAGGGACAGACTTGATAGAGACGGACGAA|GGACGAAAGGGACAGACTTGATTCACCGAA
ACTTGATTACACTAGCACATGACGTGCACT|ACGAAAGGGACAGACTTGATTACGGACGAA
ATAACGTCTTATAACAGACGCTTAATTTAA|ATCCGATCAATAGAGACGGACGAAAGGGAC
GACGGACGAAAGGGACAGACTTGATTACGG|CTAGAGACGGACGAAAGGGACAGACTTGAT
GATTACACTAGCACATGACGTGCACTCAAG|AAGGGACAGACTTGATTACGGACGAAAGGG
ACAGATAGAGACGGACGAAAGGGACAGACT|TCACATAAAATTGGAGACTATGTGGCATTT
GACAGACTTGATTAACTTATTCGTAAGCGT|GGGACAGACTTGATTGACAGTGTAATGGTG
CTTATAACTCTTCCCCGTTAGGAATCTGGA|GCGGAACCGATTAACTACGACCAGCTGTAA
CCAGAAAGTCGGACTCTCGATCCGATCAAT|TATTAGAGACGGACGAAAGGGACAGACTTG
AGACTTGATTCAGCCACGATATCTCTAGGC|TAAGCGTCTCCGTCTTAAACTAGAGACGGA
ACACCGTAGGGCCCCTCACTCAATCAAGGT|GACAGACTTGATTGACGAAAGGGACAGACT
GGCTCGTAGGCATGAGTTCAGTCGTATGGT|GGGTTAGTGCTGTCGATCGCGGATGGGAAA
TCAGCCACGATATCTCTAGGCAGCAAACAT|CCGTCTTAAACTAGAGACGGACGAAAGGGA
GATGAGCACGCCTAGAGACGGACGAAAGGG|AGACAGCGGACTGCTAGAGACGGACGAAAG
AAAGGGACAGACTTGATTTTAGATGCCTTA|AAATCAAGTTCCACCAGCTGGAGACAGACA
CAATAGAGACGGACGAAAGGGACAGACTTG|CTTGATTTTAGAGACGGACGAAAGGGACAG
TATTAGGACAGACCCCAAGACATTCAAGTC|AGTAGGGGACACACACTCGTTCTCAATAAC
CACCGTAGGGCCCCTCACTCAATCAAGGTC|ACAGACTTGATTGACGAAAGGGACAGACTT
CCGTTAGGAATCTGGAAACATTTCACCTGT|CTACGACCAGCTGTAAGTCTGGAGTAGCTG
GTCTTATAACAGACGCTTAATTTAAGGTCC|ATCAATAGAGACGGACGAAAGGGACAGACT
AAGGGACAGACTTGATTGACAGTGTAATGG|GTAACTTCTCGACCTAGCCCCGCACACGGA
ATTTGACGAAGTAGGGGACACACACTCGTT|GTCCAGGTTAATTGCCCAGAAAGTCGGACT
TCCCGTTTGTCCCAGCCCACCACAGGGTGA|GTCTAGAGACGGACGAAAGGGACAGATAGA
ACGGACGAAAGGGACAGACTTGATTTTAGA|AAATAGAGACGGACGAAAGGGACAGACTTG
AGAAGCACTCGGCCGATCTGGGTATCCCGT|ACATTCAAGTCTCGATTGAACAGTGTCTAG
CATAAAATTGGAGACTATGTGGCATTTAAT|GACGGACGAAAGGGACAGACTTGATTTTAG
AGGGACAGACTTGATTCACCGAAATCAAGT|TAACTCTTCCCCGTTAGGAATCTGGAAACA
CAAGTTCCACCAGCTGGAGACAGACACTGG|AAACATTTCACCTGTGGGGTGATTGCCCTT
GACAGCGGACTGCTAGAGACGGACGAAAGG|GGGTGAGTTAGGTTTTGTTACTAACTGTAA
CGAAATCAAGTTCCACCAGCTGGAGACAGA|ATCTGGAAACATTTCACCTGTGGGGTGATT
GAAGCTTATTTGAGATCAGTCGTCCAGGTT|CCTTATTTGCGAGGTGAGGTGCCGTTCATC
GCGAGGTGAGGTGCCGTTCATCTGAGTTTA|GAGCATTTCATCACGAGCCCGCCATCAAGC
TTATTCTTATAACTCTTCCCCGTTAGGAAT|CCGAGGCGGAACCGATTAACTACGACCAGC
TGATTGTGTAGATCTTGGTAGATCGCAACG|GATCTGGGTATCCCGTTTGTCCCAGCCCAC
ATTACGGACGAAAGGGACAGACTTGATTCA|ACTTGATTAACTTATTCGTAAGCGTCTCCG
TTGATTTTAGATGCCTTATTTGCGAGGTGA|ACCAGCTGGAGACAGACACTGGAGCATTTC
CTCGGCCGATCTGGGTATCCCGTTTGTCCC|AGTCTCGATTGAACAGTGTCTAGAGACGGA
AATCCCTGCGGCAACAGAAGCACTCGGCCG|AGGACAGACCCCAAGACATTCAAGTCTCGA
TGGGTATCCCGTTTGTCCCAGCCCACCACA|AACAGTGTCTAGAGACGGACGAAAGGGACA
CCAAGACATTCAAGTCTCGATTGAACAGTG|ACTCGTTCTCAATAACGTCTTATAACAGAC
TGATTCAGCCACGATATCTCTAGGCAGCAA|GTCTCCGTCTTAAACTAGAGACGGACGAAA
TCGGACTCTCGATCCGATCAATAGAGACGG|ACGGACGAAAGGGACAGACTTGATTTTAGA
GGAGCATTTCATCACGAGCCCGCCATCAAG|TTCGGCCGCGGACTAGGCTCGTAGGCATGA
GAGACTATGTGGCATTTAATAGCGAAGCTT|AGGGACAGACTTGATTTTAGATGCCTTATT
CGGACGAAAGGGACAGACTTGATAGAGACG|AGAGACGGACGAAAGGGACAGACTTGATTC
TGTAATGGTGAGTATGGAGAATCCCTGCGG|CACACGGATGCGTACTATTAGGACAGACCC
GACTAGGCTCGTAGGCATGAGTTCAGTCGT|AGCCCGGGTTAGTGCTGTCGATCGCGGATG
GTGGGGTGATTGCCCTTCGGCCGCGGACTA|TGTACGTGTATACCGCGGGATTCGAAGCCC
CGAGGTGAGGTGCCGTTCATCTGAGTTTAT|AGCATTTCATCACGAGCCCGCCATCAAGCT
GTACTCGGTCTGTAGAGTAGAGACGGACGA|TCCCTGCAGTGATGAGCACGCCTAGAGACG
CTCGATCCGATCAATAGAGACGGACGAAAG|AAAGGGACAGACTTGATTTTAGAGACGGAC
GACTTGATTGGTTACAACGTACTCGGTCTG|ACAAGCTAGCTCGGTTCCTCCCTGCAGTGA
AGCACGCCTAGAGACGGACGAAAGGGACAG|AGCGGACTGCTAGAGACGGACGAAAGGGAC
GATTACGGACGAAAGGGACAGACTTGATTC|GACTTGATTAACTTATTCGTAAGCGTCTCC
AGTCGGACTCTCGATCCGATCAATAGAGAC|AGACGGACGAAAGGGACAGACTTGATTTTA
TATTTGAGATCAGTCGTCCAGGTTAATTGC|TTGCGAGGTGAGGTGCCGTTCATCTGAGTT
ACTTGATTCAGCCACGATATCTCTAGGCAG|AGCGTCTCCGTCTTAAACTAGAGACGGACG
CATCTGAGTTTATTAGAGACGGACGAAAGG|CCGCCATCAAGCTAGTCCAAATAGAGACGG
CTTATTCGTAAGCGTCTCCGTCTTAAACTA|GACAGTGTAATGGTGAGTATGGAGAATCCC
ATTCTTGATTATCTAGTTGCGTACTATTTG|TAGCGAAGCTTATTTGAGATCAGTCGTCCA
AGTTTATTAGAGACGGACGAAAGGGACAGA|TCAAGCTAGTCCAAATAGAGACGGACGAAA
CAGACTTGATTCAGCCACGATATCTCTAGG|GTAAGCGTCTCCGTCTTAAACTAGAGACGG
ATTCACCGAAATCAAGTTCCACCAGCTGGA|TTAGGAATCTGGAAACATTTCACCTGTGGG
TTGATAGAGACGGACGAAAGGGACAGACTT|CAGACTTGATTCACCGAAATCAAGTTCCAC
GTCGGACTCTCGATCCGATCAATAGAGACG|GACGGACGAAAGGGACAGACTTGATTTTAG
TGACAGTGTAATGGTGAGTATGGAGAATCC|GCCCCGCACACGGATGCGTACTATTAGGAC
AAAGGGACAGACTTGATTGACAGTGTAATG|TGTAACTTCTCGACCTAGCCCCGCACACGG
CTAGAGACGGACGAAAGGGACAGACTTGAT|CTCGGTCTGTAGAGTAGAGACGGACGAAAG
ACTGGAGCATTTCATCACGAGCCCGCCATC|CCCTTCGGCCGCGGACTAGGCTCGTAGGCA
TAGAGACGGACGAAAGGGACAGACTTGATT|TAAAATTGGAGACTATGTGGCATTTAATAG
CAGATAGAGACGGACGAAAGGGACAGACTT|CACATAAAATTGGAGACTATGTGGCATTTA
ACTCAAGTTAGAGACGTAGAGACGGACGAA|GAAAGGGACAGACTTGATTCAGCCACGATA
CGAAAGGGACAGATAGAGACGGACGAAAGG|GTCCGCTTTCACATAAAATTGGAGACTATG
GTTACAACGTACTCGGTCTGTAGAGTAGAG|TCGGTTCCTCCCTGCAGTGATGAGCACGCC
ACAGCGGACTGCTAGAGACGGACGAAAGGG|GGTGAGTTAGGTTTTGTTACTAACTGTAAC
TGAACAGTGTCTAGAGACGGACGAAAGGGA|ATAACAGACGCTTAATTTAAGGTCCGCTTT
GACAGACTTGATTGACAGTGTAATGGTGAG|CTTCTCGACCTAGCCCCGCACACGGATGCG
ACAGACCCCAAGACATTCAAGTCTCGATTG|GACACACACTCGTTCTCAATAACGTCTTAT
GAGACGGACGAAAGGGACAGACTTGATTCA|TGATTATTCTTATAACTCTTCCCCGTTAGG
TTTATTAGAGACGGACGAAAGGGACAGACT|AAGCTAGTCCAAATAGAGACGGACGAAAGG
TACTCGGTCTGTAGAGTAGAGACGGACGAA|CCCTGCAGTGATGAGCACGCCTAGAGACGG
GATTATTCTTATAACTCTTCCCCGTTAGGA|TACCGAGGCGGAACCGATTAACTACGACCA
ACACACTCGTTCTCAATAACGTCTTATAAC|AAAGTCGGACTCTCGATCCGATCAATAGAG
GGGGTGATTGCCCTTCGGCCGCGGACTAGG|TACGTGTATACCGCGGGATTCGAAGCCCGG
GACGGACGAAAGGGACAGATAGAGACGGAC|TTTAAGGTCCGCTTTCACATAAAATTGGAG
TATTAGAGACGGACGAAAGGGACAGACTTG|GCTAGTCCAAATAGAGACGGACGAAAGGGA
GACAGATAGAGACGGACGAAAGGGACAGAC|TTCACATAAAATTGGAGACTATGTGGCATT
AGTCTCGATTGAACAGTGTCTAGAGACGGA|TAACGTCTTATAACAGACGCTTAATTTAAG
GAAAGGGACAGACTTGATTACACTAGCACA|AGTAGAGACGGACGAAAGGGACAGACTTGA
ATAGCGAAGCTTATTTGAGATCAGTCGTCC|AGATGCCTTATTTGCGAGGTGAGGTGCCGT
GGACAGATAGAGACGGACGAAAGGGACAGA|TTTCACATAAAATTGGAGACTATGTGGCAT
CGAAAGGGACAGACTTGATTCACCGAAATC|CTTATAACTCTTCCCCGTTAGGAATCTGGA
GAAAGGGACAGACTTGATTGGTTACAACGT|AGGGGTTGGCACAAGCTAGCTCGGTTCCTC
AAGTTAGAGACGTAGAGACGGACGAAAGGG|GGGACAGACTTGATTCAGCCACGATATCTC
CTTCTAGAGACGGACGAAAGGGACAGACTT|GTACTCGGTCTGTAGAGTAGAGACGGACGA
TGTCTAGAGACGGACGAAAGGGACAGATAG|ACGCTTAATTTAAGGTCCGCTTTCACATAA
TTGATTCACCGAAATCAAGTTCCACCAGCT|CCGTTAGGAATCTGGAAACATTTCACCTGT
ACGGACGAAAGGGACAGACTTGATTGACGA|GCCACGATATCTCTAGGCAGCAAACATGAG
TACAACGTACTCGGTCTGTAGAGTAGAGAC|GGTTCCTCCCTGCAGTGATGAGCACGCCTA
CGGACGAAAGGGACAGACTTGATTGTGTAG|GCAACAGAAGCACTCGGCCGATCTGGGTAT
AGACACTGGAGCATTTCATCACGAGCCCGC|ATTGCCCTTCGGCCGCGGACTAGGCTCGTA
TAGGAATCTGGAAACATTTCACCTGTGGGG|GACCAGCTGTAAGTCTGGAGTAGCTGTACG
TGGAAACATTTCACCTGTGGGGTGATTGCC|GTAAGTCTGGAGTAGCTGTACGTGTATACC
TGCTAGAGACGGACGAAAGGGACAGACTTG|GGTTTTGTTACTAACTGTAACTTCTCGACC
CGTAAGCGTCTCCGTCTTAAACTAGAGACG|GTAATGGTGAGTATGGAGAATCCCTGCGGC
TTAGAGACGGACGAAAGGGACAGACTTGAT|ACTTGATTATTCTTATAACTCTTCCCCGTT
ACACTGGAGCATTTCATCACGAGCCCGCCA|TGCCCTTCGGCCGCGGACTAGGCTCGTAGG
GCAACAGAAGCACTCGGCCGATCTGGGTAT|CCAAGACATTCAAGTCTCGATTGAACAGTG
ACTCTCGATCCGATCAATAGAGACGGACGA|ACGAAAGGGACAGACTTGATTTTAGAGACG
TAGAGACGGACGAAAGGGACAGACTTGATT|AGTCCAAATAGAGACGGACGAAAGGGACAG
CCACAGGGTGAGTTAGGTTTTGTTACTAAC|GGACAGATAGAGACGGACGAAAGGGACAGA
GATTCAGCCACGATATCTCTAGGCAGCAAA|TCTCCGTCTTAAACTAGAGACGGACGAAAG
TCAAGGTCTGATACTCACAATCTTCTAGAG|ACAGACTTGATTGGTTACAACGTACTCGGT
TCGCAACGACGAGACAGCGGACTGCTAGAG|CAGCCCACCACAGGGTGAGTTAGGTTTTGT
ATTCAGCCACGATATCTCTAGGCAGCAAAC|CTCCGTCTTAAACTAGAGACGGACGAAAGG
TTGCGAGGTGAGGTGCCGTTCATCTGAGTT|TGGAGCATTTCATCACGAGCCCGCCATCAA
CCCTTCGGCCGCGGACTAGGCTCGTAGGCA|CCGCGGGATTCGAAGCCCGGGTTAGTGCTG
CCCAAGACATTCAAGTCTCGATTGAACAGT|CACTCGTTCTCAATAACGTCTTATAACAGA
TGAGGTGCCGTTCATCTGAGTTTATTAGAG|TTCATCACGAGCCCGCCATCAAGCTAGTCC
GGACTAGGCTCGTAGGCATGAGTTCAGTCG|AAGCCCGGGTTAGTGCTGTCGATCGCGGAT
ACGACGAGACAGCGGACTGCTAGAGACGGA|CACCACAGGGTGAGTTAGGTTTTGTTACTA
GGGACAGACTTGATTTTAGAGACGGACGAA|GGACGAAAGGGACAGACTTGATTATTCTTA
ACGAAAGGGACAGACTTGATTGACGAAAGG|CGATATCTCTAGGCAGCAAACATGAGGGGT
ACAACGTACTCGGTCTGTAGAGTAGAGACG|GTTCCTCCCTGCAGTGATGAGCACGCCTAG
ATCACGAGCCCGCCATCAAGCTAGTCCAAA|GACTAGGCTCGTAGGCATGAGTTCAGTCGT
GACTTGATAGAGACGGACGAAAGGGACAGA|GGACAGACTTGATTCACCGAAATCAAGTTC
GAAGTAGGGGACACACACTCGTTCTCAATA|TTAATTGCCCAGAAAGTCGGACTCTCGATC
ATTTAATAGCGAAGCTTATTTGAGATCAGT|ATTTTAGATGCCTTATTTGCGAGGTGAGGT
CTTGATTGACGAAAGGGACAGACTTGATTG|AGCAAACATGAGGGGTTGGCACAAGCTAGC
CACTGGAGCATTTCATCACGAGCCCGCCAT|GCCCTTCGGCCGCGGACTAGGCTCGTAGGC
TTCTCGACCTAGCCCCGCACACGGATGCGT|TCTTGATTATCTAGTTGCGTACTATTTGAC
AAGGGACAGACTTGATTTTAGATGCCTTAT|AATCAAGTTCCACCAGCTGGAGACAGACAC
GCTTTCACATAAAATTGGAGACTATGTGGC|TGATAGAGACGGACGAAAGGGACAGACTTG
CAAGCTAGCTCGGTTCCTCCCTGCAGTGAT|TGTAGATCTTGGTAGATCGCAACGACGAGA
GGGACAGACTTGATTCAGCCACGATATCTC|ATTCGTAAGCGTCTCCGTCTTAAACTAGAG
CAGACTTGATTTTAGAGACGGACGAAAGGG|GAAAGGGACAGACTTGATTATTCTTATAAC
TGGGGTGATTGCCCTTCGGCCGCGGACTAG|GTACGTGTATACCGCGGGATTCGAAGCCCG
CAGACACTGGAGCATTTCATCACGAGCCCG|GATTGCCCTTCGGCCGCGGACTAGGCTCGT
ACAGACTTGATTGACAGTGTAATGGTGAGT|TTCTCGACCTAGCCCCGCACACGGATGCGT
TAGGACAGACCCCAAGACATTCAAGTCTCG|AGGGGACACACACTCGTTCTCAATAACGTC
TGCCCAGAAAGTCGGACTCTCGATCCGATC|GTTTATTAGAGACGGACGAAAGGGACAGAC
ACAGACTTGATTCACCGAAATCAAGTTCCA|TCTTCCCCGTTAGGAATCTGGAAACATTTC
GGAATCTGGAAACATTTCACCTGTGGGGTG|CCAGCTGTAAGTCTGGAGTAGCTGTACGTG
GAGACGGACGAAAGGGACAGACTTGATTCT|AAATTGGAGACTATGTGGCATTTAATAGCG
AAGCACTCGGCCGATCTGGGTATCCCGTTT|ATTCAAGTCTCGATTGAACAGTGTCTAGAG
GCACTCGGCCGATCTGGGTATCCCGTTTGT|TCAAGTCTCGATTGAACAGTGTCTAGAGAC
CGTCTCCGTCTTAAACTAGAGACGGACGAA|GTGAGTATGGAGAATCCCTGCGGCAACAGA
GGACAGACTTGATTACACTAGCACATGACG|AGACGGACGAAAGGGACAGACTTGATTACG
TCTTCTAGAGACGGACGAAAGGGACAGACT|CGTACTCGGTCTGTAGAGTAGAGACGGACG
CAGGGTGAGTTAGGTTTTGTTACTAACTGT|CAGATAGAGACGGACGAAAGGGACAGACTT
TCAAGTCTCGATTGAACAGTGTCTAGAGAC|CAATAACGTCTTATAACAGACGCTTAATTT
TGATTGGTTACAACGTACTCGGTCTGTAGA|GCTAGCTCGGTTCCTCCCTGCAGTGATGAG
AGATCTTGGTAGATCGCAACGACGAGACAG|ATCCCGTTTGTCCCAGCCCACCACAGGGTG
GACAGACTTGATTATTCTTATAACTCTTCC|GCTCGGCCCTACCGAGGCGGAACCGATTAA
AGAGACGGACGAAAGGGACAGACTTGATTA|TGGTGAATATGCGTACGCTCGGCCCTACCG
GTACTATTTGACGAAGTAGGGGACACACAC|CAGTCGTCCAGGTTAATTGCCCAGAAAGTC
TTGCCCTTCGGCCGCGGACTAGGCTCGTAG|ATACCGCGGGATTCGAAGCCCGGGTTAGTG
TCTGGAAACATTTCACCTGTGGGGTGATTG|CTGTAAGTCTGGAGTAGCTGTACGTGTATA
AGAGACGGACGAAAGGGACAGATAGAGACG|TAATTTAAGGTCCGCTTTCACATAAAATTG
ACGCCTAGAGACGGACGAAAGGGACAGACT|GGACTGCTAGAGACGGACGAAAGGGACAGA
TCAAGCTAGTCCAAATAGAGACGGACGAAA|CATGAGTTCAGTCGTATGGTGAATATGCGT
GACAGACTTGATTGTGTAGATCTTGGTAGA|ACTCGGCCGATCTGGGTATCCCGTTTGTCC
AAGGGACAGACTTGATTCACCGAAATCAAG|ATAACTCTTCCCCGTTAGGAATCTGGAAAC
CTCGACCTAGCCCCGCACACGGATGCGTAC|TTGATTATCTAGTTGCGTACTATTTGACGA
CGGCCGATCTGGGTATCCCGTTTGTCCCAG|TCTCGATTGAACAGTGTCTAGAGACGGACG
GGACGAAAGGGACAGACTTGATTACGGACG|GAGACGGACGAAAGGGACAGACTTGATTAA
GATCGCAACGACGAGACAGCGGACTGCTAG|CCCAGCCCACCACAGGGTGAGTTAGGTTTT
ATCCCGTTTGTCCCAGCCCACCACAGGGTG|TGTCTAGAGACGGACGAAAGGGACAGATAG
GCACAAGCTAGCTCGGTTCCTCCCTGCAGT|TTGTGTAGATCTTGGTAGATCGCAACGACG
AGGGGACACACACTCGTTCTCAATAACGTC|TGCCCAGAAAGTCGGACTCTCGATCCGATC
GACTTGATTGACGAAAGGGACAGACTTGAT|GCAGCAAACATGAGGGGTTGGCACAAGCTA
GATGCCTTATTTGCGAGGTGAGGTGCCGTT|AGACAGACACTGGAGCATTTCATCACGAGC
GATTAACTTATTCGTAAGCGTCTCCGTCTT|TTGATTGACAGTGTAATGGTGAGTATGGAG
ATTGCCCAGAAAGTCGGACTCTCGATCCGA|GAGTTTATTAGAGACGGACGAAAGGGACAG
TTGGCACAAGCTAGCTCGGTTCCTCCCTGC|TGATTGTGTAGATCTTGGTAGATCGCAACG
CTAGTTGCGTACTATTTGACGAAGTAGGGG|TTTGAGATCAGTCGTCCAGGTTAATTGCCC
AGACTATGTGGCATTTAATAGCGAAGCTTA|GGGACAGACTTGATTTTAGATGCCTTATTT
GGGGTTGGCACAAGCTAGCTCGGTTCCTCC|GACTTGATTGTGTAGATCTTGGTAGATCGC
CAGACTTGATTTTAGATGCCTTATTTGCGA|GTTCCACCAGCTGGAGACAGACACTGGAGC
CGTCTTAAACTAGAGACGGACGAAAGGGAC|ATGGAGAATCCCTGCGGCAACAGAAGCACT
TGGTTACAACGTACTCGGTCTGTAGAGTAG|GCTCGGTTCCTCCCTGCAGTGATGAGCACG
TAACTGTAACTTCTCGACCTAGCCCCGCAC|CAGACTTGATTCTTGATTATCTAGTTGCGT
GAGACAGCGGACTGCTAGAGACGGACGAAA|CAGGGTGAGTTAGGTTTTGTTACTAACTGT
AGACAGACACTGGAGCATTTCATCACGAGC|GGTGATTGCCCTTCGGCCGCGGACTAGGCT
CAGACTTGATTCTTGATTATCTAGTTGCGT|GCATTTAATAGCGAAGCTTATTTGAGATCA
AAAGGGACAGACTTGATTCACCGAAATCAA|TATAACTCTTCCCCGTTAGGAATCTGGAAA
ACACACACTCGTTCTCAATAACGTCTTATA|AGAAAGTCGGACTCTCGATCCGATCAATAG
CTCACTCAATCAAGGTCTGATACTCACAAT|ACGAAAGGGACAGACTTGATTGGTTACAAC
GACGAAAGGGACAGACTTGATTACACTAGC|TAGAGTAGAGACGGACGAAAGGGACAGACT
ATAGAGACGGACGAAAGGGACAGACTTGAT|ATAAAATTGGAGACTATGTGGCATTTAATA
AAGGGACAGACTTGATTACGGACGAAAGGG|GACGAAAGGGACAGACTTGATTAACTTATT
CGCCTAGAGACGGACGAAAGGGACAGACTT|GACTGCTAGAGACGGACGAAAGGGACAGAC
TTGATTTTAGAGACGGACGAAAGGGACAGA|GGACAGACTTGATTATTCTTATAACTCTTC
TTGTCCCAGCCCACCACAGGGTGAGTTAGG|AGACGGACGAAAGGGACAGATAGAGACGGA
GAGACGGACGAAAGGGACAGACTTGATTGT|TGCGGCAACAGAAGCACTCGGCCGATCTGG
AGACGGACGAAAGGGACAGACTTGATTACG|CCTAGAGACGGACGAAAGGGACAGACTTGA
ACGGACGAAAGGGACAGACTTGATTTTAGA|TTCACCGAAATCAAGTTCCACCAGCTGGAG
TAGCACATGACGTGCACTCAAGTTAGAGAC|GACTTGATTACGGACGAAAGGGACAGACTT
CTGAGTTTATTAGAGACGGACGAAAGGGAC|CCATCAAGCTAGTCCAAATAGAGACGGACG
TACTATTAGGACAGACCCCAAGACATTCAA|CGAAGTAGGGGACACACACTCGTTCTCAAT
TTGACAGTGTAATGGTGAGTATGGAGAATC|AGCCCCGCACACGGATGCGTACTATTAGGA
AGGCTCGTAGGCATGAGTTCAGTCGTATGG|CGGGTTAGTGCTGTCGATCGCGGATGGGAA
GAAGCACTCGGCCGATCTGGGTATCCCGTT|CATTCAAGTCTCGATTGAACAGTGTCTAGA
GACGAAAGGGACAGACTTGATTGACAGTGT|TAACTGTAACTTCTCGACCTAGCCCCGCAC
ACATTTCACCTGTGGGGTGATTGCCCTTCG|TCTGGAGTAGCTGTACGTGTATACCGCGGG
CTTGATAGAGACGGACGAAAGGGACAGACT|ACAGACTTGATTCACCGAAATCAAGTTCCA
AGCCCACCACAGGGTGAGTTAGGTTTTGTT|CGAAAGGGACAGATAGAGACGGACGAAAGG
CAGACTTGATTGACGAAAGGGACAGACTTG|AGGCAGCAAACATGAGGGGTTGGCACAAGC
AAAGGGACAGACTTGATTACACTAGCACAT|GTAGAGACGGACGAAAGGGACAGACTTGAT
TGGCATTTAATAGCGAAGCTTATTTGAGAT|CTTGATTTTAGATGCCTTATTTGCGAGGTG
GCTAGTCCAAATAGAGACGGACGAAAGGGA|AGTTCAGTCGTATGGTGAATATGCGTACGC
AGGGACAGACTTGATTGTGTAGATCTTGGT|AGCACTCGGCCGATCTGGGTATCCCGTTTG
GGGTGAGTTAGGTTTTGTTACTAACTGTAA|GATAGAGACGGACGAAAGGGACAGACTTGA
ACGAAAGGGACAGATAGAGACGGACGAAAG|GGTCCGCTTTCACATAAAATTGGAGACTAT
CCCTGCGGCAACAGAAGCACTCGGCCGATC|ACAGACCCCAAGACATTCAAGTCTCGATTG
GAGGTGAGGTGCCGTTCATCTGAGTTTATT|GCATTTCATCACGAGCCCGCCATCAAGCTA
GGAGAATCCCTGCGGCAACAGAAGCACTCG|TATTAGGACAGACCCCAAGACATTCAAGTC
ACTTGATTATTCTTATAACTCTTCCCCGTT|GCCCTACCGAGGCGGAACCGATTAACTACG
TCTGTAGAGTAGAGACGGACGAAAGGGACA|GTGATGAGCACGCCTAGAGACGGACGAAAG
TTCACATAAAATTGGAGACTATGTGGCATT|TAGAGACGGACGAAAGGGACAGACTTGATT
TCAATAGAGACGGACGAAAGGGACAGACTT|ACTTGATTTTAGAGACGGACGAAAGGGACA
GGTTGGCACAAGCTAGCTCGGTTCCTCCCT|CTTGATTGTGTAGATCTTGGTAGATCGCAA
CAACGACGAGACAGCGGACTGCTAGAGACG|CCCACCACAGGGTGAGTTAGGTTTTGTTAC
CCACGATATCTCTAGGCAGCAAACATGAGG|CTTAAACTAGAGACGGACGAAAGGGACAGA
GACGGACGAAAGGGACAGACTTGATAGAGA|TTAGAGACGGACGAAAGGGACAGACTTGAT
CACAAGCTAGCTCGGTTCCTCCCTGCAGTG|TGTGTAGATCTTGGTAGATCGCAACGACGA
CCTAGAGACGGACGAAAGGGACAGACTTGA|CTGCTAGAGACGGACGAAAGGGACAGACTT
CATCAAGCTAGTCCAAATAGAGACGGACGA|GGCATGAGTTCAGTCGTATGGTGAATATGC
CCCCGCACACGGATGCGTACTATTAGGACA|AGTTGCGTACTATTTGACGAAGTAGGGGAC
CGGACGAAAGGGACAGACTTGATTTTAGAT|TCACCGAAATCAAGTTCCACCAGCTGGAGA
CGGTTCCTCCCTGCAGTGATGAGCACGCCT|GGTAGATCGCAACGACGAGACAGCGGACTG
CGGTCTGTAGAGTAGAGACGGACGAAAGGG|GCAGTGATGAGCACGCCTAGAGACGGACGA
TTGGTTACAACGTACTCGGTCTGTAGAGTA|AGCTCGGTTCCTCCCTGCAGTGATGAGCAC
TCTCGATTGAACAGTGTCTAGAGACGGACG|ACGTCTTATAACAGACGCTTAATTTAAGGT
AGGTGCCGTTCATCTGAGTTTATTAGAGAC|CATCACGAGCCCGCCATCAAGCTAGTCCAA
TACTCACAATCTTCTAGAGACGGACGAAAG|TGGTTACAACGTACTCGGTCTGTAGAGTAG
CAGACTTGATTCACCGAAATCAAGTTCCAC|CTTCCCCGTTAGGAATCTGGAAACATTTCA
GGACGAAAGGGACAGACTTGATTTTAGAGA|ATAGAGACGGACGAAAGGGACAGACTTGAT
ACGGACGAAAGGGACAGACTTGATTCAGCC|TGATTAACTTATTCGTAAGCGTCTCCGTCT
CTATTAGGACAGACCCCAAGACATTCAAGT|AAGTAGGGGACACACACTCGTTCTCAATAA
TTCACCGAAATCAAGTTCCACCAGCTGGAG|TAGGAATCTGGAAACATTTCACCTGTGGGG
GATATCTCTAGGCAGCAAACATGAGGGGTT|AACTAGAGACGGACGAAAGGGACAGACTTG
AGTCGTCCAGGTTAATTGCCCAGAAAGTCG|GGTGCCGTTCATCTGAGTTTATTAGAGACG
ACAGACGCTTAATTTAAGGTCCGCTTTCAC|AGACGGACGAAAGGGACAGACTTGATAGAG
GAATCCCTGCGGCAACAGAAGCACTCGGCC|TAGGACAGACCCCAAGACATTCAAGTCTCG
CTCGGTCTGTAGAGTAGAGACGGACGAAAG|CTGCAGTGATGAGCACGCCTAGAGACGGAC
GACGGACGAAAGGGACAGACTTGATTTTAG|CAAATAGAGACGGACGAAAGGGACAGACTT
GATAGAGACGGACGAAAGGGACAGACTTGA|CATAAAATTGGAGACTATGTGGCATTTAAT
GGGCCCCTCACTCAATCAAGGTCTGATACT|TGATTGACGAAAGGGACAGACTTGATTGGT
CACTAGCACATGACGTGCACTCAAGTTAGA|ACAGACTTGATTACGGACGAAAGGGACAGA
TAAAATTGGAGACTATGTGGCATTTAATAG|CGGACGAAAGGGACAGACTTGATTTTAGAT
TAGCGAAGCTTATTTGAGATCAGTCGTCCA|GATGCCTTATTTGCGAGGTGAGGTGCCGTT
GCCCTTCGGCCGCGGACTAGGCTCGTAGGC|ACCGCGGGATTCGAAGCCCGGGTTAGTGCT
GGTTCCTCCCTGCAGTGATGAGCACGCCTA|GTAGATCGCAACGACGAGACAGCGGACTGC
TCGGCCGCGGACTAGGCTCGTAGGCATGAG|GGGATTCGAAGCCCGGGTTAGTGCTGTCGA
AGAGACGGACGAAAGGGACAGACTTGATAG|ATTTTAGAGACGGACGAAAGGGACAGACTT
CGAAGCTTATTTGAGATCAGTCGTCCAGGT|GCCTTATTTGCGAGGTGAGGTGCCGTTCAT
ACTAGAGACGGACGAAAGGGACAGACTTGA|TCCCTGCGGCAACAGAAGCACTCGGCCGAT
AGAGACGGACGAAAGGGACAGACTTGATTT|TTGATTCACCGAAATCAAGTTCCACCAGCT
TTCTAGAGACGGACGAAAGGGACAGACTTG|TACTCGGTCTGTAGAGTAGAGACGGACGAA
CTTGATTACGGACGAAAGGGACAGACTTGA|ACAGACTTGATTAACTTATTCGTAAGCGTC
CAGCCACGATATCTCTAGGCAGCAAACATG|CGTCTTAAACTAGAGACGGACGAAAGGGAC
AATGGTGAGTATGGAGAATCCCTGCGGCAA|ACGGATGCGTACTATTAGGACAGACCCCAA
CACACGGATGCGTACTATTAGGACAGACCC|CGTACTATTTGACGAAGTAGGGGACACACA
GACTGCTAGAGACGGACGAAAGGGACAGAC|TTAGGTTTTGTTACTAACTGTAACTTCTCG
ACTGCTAGAGACGGACGAAAGGGACAGACT|TAGGTTTTGTTACTAACTGTAACTTCTCGA
ACGAAAGGGACAGACTTGATTAACTTATTC|GGACGAAAGGGACAGACTTGATTGACAGTG
GACGAAGTAGGGGACACACACTCGTTCTCA|AGGTTAATTGCCCAGAAAGTCGGACTCTCG
TCCTCCCTGCAGTGATGAGCACGCCTAGAG|GATCGCAACGACGAGACAGCGGACTGCTAG
AGACGGACGAAAGGGACAGACTTGATTCAC|GATTATTCTTATAACTCTTCCCCGTTAGGA
TGAGTTAGGTTTTGTTACTAACTGTAACTT|AGAGACGGACGAAAGGGACAGACTTGATTC
TGATACTCACAATCTTCTAGAGACGGACGA|GATTGGTTACAACGTACTCGGTCTGTAGAG
CGATCAATAGAGACGGACGAAAGGGACAGA|CAGACTTGATTTTAGAGACGGACGAAAGGG
CCAAATAGAGACGGACGAAAGGGACAGACT|GTCGTATGGTGAATATGCGTACGCTCGGCC
CAGACGCTTAATTTAAGGTCCGCTTTCACA|GACGGACGAAAGGGACAGACTTGATAGAGA
GGGACACACACTCGTTCTCAATAACGTCTT|CCCAGAAAGTCGGACTCTCGATCCGATCAA
TGTCCCAGCCCACCACAGGGTGAGTTAGGT|GACGGACGAAAGGGACAGATAGAGACGGAC
ATGCCTTATTTGCGAGGTGAGGTGCCGTTC|GACAGACACTGGAGCATTTCATCACGAGCC
GCGTCTCCGTCTTAAACTAGAGACGGACGA|GGTGAGTATGGAGAATCCCTGCGGCAACAG
TAACAGACGCTTAATTTAAGGTCCGCTTTC|AGAGACGGACGAAAGGGACAGACTTGATAG
TATTCTTATAACTCTTCCCCGTTAGGAATC|CGAGGCGGAACCGATTAACTACGACCAGCT
GAGGGGTTGGCACAAGCTAGCTCGGTTCCT|CAGACTTGATTGTGTAGATCTTGGTAGATC
GACTTGATTCTTGATTATCTAGTTGCGTAC|ATTTAATAGCGAAGCTTATTTGAGATCAGT
CTCTTCCCCGTTAGGAATCTGGAAACATTT|CGATTAACTACGACCAGCTGTAAGTCTGGA
CCCTCACTCAATCAAGGTCTGATACTCACA|TGACGAAAGGGACAGACTTGATTGGTTACA
GAGACGGACGAAAGGGACAGACTTGATTAC|GCCTAGAGACGGACGAAAGGGACAGACTTG
CAAGGTCTGATACTCACAATCTTCTAGAGA|CAGACTTGATTGGTTACAACGTACTCGGTC
CTAGCACATGACGTGCACTCAAGTTAGAGA|AGACTTGATTACGGACGAAAGGGACAGACT
TAGAGACGGACGAAAGGGACAGACTTGATT|TCGGTCTGTAGAGTAGAGACGGACGAAAGG
CTGGAGACAGACACTGGAGCATTTCATCAC|GTGGGGTGATTGCCCTTCGGCCGCGGACTA
AGACGGACGAAAGGGACAGACTTGATTTTA|GATTCACCGAAATCAAGTTCCACCAGCTGG
TGATTCTTGATTATCTAGTTGCGTACTATT|AATAGCGAAGCTTATTTGAGATCAGTCGTC
CGTTCTCAATAACGTCTTATAACAGACGCT|GACTCTCGATCCGATCAATAGAGACGGACG
CGTGCACTCAAGTTAGAGACGTAGAGACGG|CGGACGAAAGGGACAGACTTGATTCAGCCA
GACTTGATTCAGCCACGATATCTCTAGGCA|AAGCGTCTCCGTCTTAAACTAGAGACGGAC
GACGGACGAAAGGGACAGACTTGATTACAC|TCTGTAGAGTAGAGACGGACGAAAGGGACA
ACTTGATTGGTTACAACGTACTCGGTCTGT|CAAGCTAGCTCGGTTCCTCCCTGCAGTGAT
CCTCCCTGCAGTGATGAGCACGCCTAGAGA|ATCGCAACGACGAGACAGCGGACTGCTAGA
TTCACCTGTGGGGTGATTGCCCTTCGGCCG|GAGTAGCTGTACGTGTATACCGCGGGATTC
CACTCAATCAAGGTCTGATACTCACAATCT|GAAAGGGACAGACTTGATTGGTTACAACGT
TTAAACTAGAGACGGACGAAAGGGACAGAC|AGAATCCCTGCGGCAACAGAAGCACTCGGC
GAGTTAGGTTTTGTTACTAACTGTAACTTC|GAGACGGACGAAAGGGACAGACTTGATTCT
GTGCCGTTCATCTGAGTTTATTAGAGACGG|TCACGAGCCCGCCATCAAGCTAGTCCAAAT
CAGCCCACCACAGGGTGAGTTAGGTTTTGT|ACGAAAGGGACAGATAGAGACGGACGAAAG
GCCATCAAGCTAGTCCAAATAGAGACGGAC|TAGGCATGAGTTCAGTCGTATGGTGAATAT
CAGTGATGAGCACGCCTAGAGACGGACGAA|GACGAGACAGCGGACTGCTAGAGACGGACG
GAGACGGACGAAAGGGACAGACTTGATTAC|GGTCTGTAGAGTAGAGACGGACGAAAGGGA
CAAGACATTCAAGTCTCGATTGAACAGTGT|CTCGTTCTCAATAACGTCTTATAACAGACG
TTTTGTTACTAACTGTAACTTCTCGACCTA|CGAAAGGGACAGACTTGATTCTTGATTATC
AGCCACGATATCTCTAGGCAGCAAACATGA|GTCTTAAACTAGAGACGGACGAAAGGGACA
AGACGGACGAAAGGGACAGACTTGATTACA|GTCTGTAGAGTAGAGACGGACGAAAGGGAC
ACGAAAGGGACAGACTTGATTGTGTAGATC|ACAGAAGCACTCGGCCGATCTGGGTATCCC
AGTGTCTAGAGACGGACGAAAGGGACAGAT|AGACGCTTAATTTAAGGTCCGCTTTCACAT
ACATTCAAGTCTCGATTGAACAGTGTCTAG|TTCTCAATAACGTCTTATAACAGACGCTTA
GTGTAGATCTTGGTAGATCGCAACGACGAG|GGGTATCCCGTTTGTCCCAGCCCACCACAG
TTGATTGACGAAAGGGACAGACTTGATTGG|GCAAACATGAGGGGTTGGCACAAGCTAGCT
ATGACGTGCACTCAAGTTAGAGACGTAGAG|ATTACGGACGAAAGGGACAGACTTGATTCA
AGTGATGAGCACGCCTAGAGACGGACGAAA|ACGAGACAGCGGACTGCTAGAGACGGACGA
GTAGAGTAGAGACGGACGAAAGGGACAGAC|ATGAGCACGCCTAGAGACGGACGAAAGGGA
TTCGGCCGCGGACTAGGCTCGTAGGCATGA|CGGGATTCGAAGCCCGGGTTAGTGCTGTCG
GGGGACACACACTCGTTCTCAATAACGTCT|GCCCAGAAAGTCGGACTCTCGATCCGATCA
TTGACGAAAGGGACAGACTTGATTGGTTAC|ACATGAGGGGTTGGCACAAGCTAGCTCGGT
CACATAAAATTGGAGACTATGTGGCATTTA|GAGACGGACGAAAGGGACAGACTTGATTTT
GAGACAGACACTGGAGCATTTCATCACGAG|GGGTGATTGCCCTTCGGCCGCGGACTAGGC
TAGAGACGGACGAAAGGGACAGACTTGATT|ATTCAGCCACGATATCTCTAGGCAGCAAAC
AGCTCGGTTCCTCCCTGCAGTGATGAGCAC|TCTTGGTAGATCGCAACGACGAGACAGCGG
GGTTAATTGCCCAGAAAGTCGGACTCTCGA|CATCTGAGTTTATTAGAGACGGACGAAAGG
GAGCCCGCCATCAAGCTAGTCCAAATAGAG|GGCTCGTAGGCATGAGTTCAGTCGTATGGT
ATCAGTCGTCCAGGTTAATTGCCCAGAAAG|TGAGGTGCCGTTCATCTGAGTTTATTAGAG
GGGTTGGCACAAGCTAGCTCGGTTCCTCCC|ACTTGATTGTGTAGATCTTGGTAGATCGCA
ATCTCTAGGCAGCAAACATGAGGGGTTGGC|TAGAGACGGACGAAAGGGACAGACTTGATT
AGGACAGACCCCAAGACATTCAAGTCTCGA|GGGGACACACACTCGTTCTCAATAACGTCT
TTTTAGATGCCTTATTTGCGAGGTGAGGTG|GCTGGAGACAGACACTGGAGCATTTCATCA
AAGTCGGACTCTCGATCCGATCAATAGAGA|GAGACGGACGAAAGGGACAGACTTGATTTT
GGGACAGACTTGATTACGGACGAAAGGGAC|CGAAAGGGACAGACTTGATTAACTTATTCG
ACGATATCTCTAGGCAGCAAACATGAGGGG|TAAACTAGAGACGGACGAAAGGGACAGACT
TCTCTAGGCAGCAAACATGAGGGGTTGGCA|AGAGACGGACGAAAGGGACAGACTTGATTG
GACTTGATTATTCTTATAACTCTTCCCCGT|GGCCCTACCGAGGCGGAACCGATTAACTAC
GACTTGATTACGGACGAAAGGGACAGACTT|GGACAGACTTGATTAACTTATTCGTAAGCG
TCAAGTTAGAGACGTAGAGACGGACGAAAG|AAGGGACAGACTTGATTCAGCCACGATATC
GCCCGCCATCAAGCTAGTCCAAATAGAGAC|CTCGTAGGCATGAGTTCAGTCGTATGGTGA
TGCGGCAACAGAAGCACTCGGCCGATCTGG|GACCCCAAGACATTCAAGTCTCGATTGAAC
ATCTGGGTATCCCGTTTGTCCCAGCCCACC|TTGAACAGTGTCTAGAGACGGACGAAAGGG
CTAACTGTAACTTCTCGACCTAGCCCCGCA|ACAGACTTGATTCTTGATTATCTAGTTGCG
TGCGAGGTGAGGTGCCGTTCATCTGAGTTT|GGAGCATTTCATCACGAGCCCGCCATCAAG
TCGACCTAGCCCCGCACACGGATGCGTACT|TGATTATCTAGTTGCGTACTATTTGACGAA
TTGATTCAGCCACGATATCTCTAGGCAGCA|CGTCTCCGTCTTAAACTAGAGACGGACGAA
TGACGAAGTAGGGGACACACACTCGTTCTC|CAGGTTAATTGCCCAGAAAGTCGGACTCTC
CGACCTAGCCCCGCACACGGATGCGTACTA|GATTATCTAGTTGCGTACTATTTGACGAAG
GCGGCAACAGAAGCACTCGGCCGATCTGGG|ACCCCAAGACATTCAAGTCTCGATTGAACA
CTATTTGACGAAGTAGGGGACACACACTCG|TCGTCCAGGTTAATTGCCCAGAAAGTCGGA
ATTTGAGATCAGTCGTCCAGGTTAATTGCC|TGCGAGGTGAGGTGCCGTTCATCTGAGTTT
GCGGACTGCTAGAGACGGACGAAAGGGACA|GAGTTAGGTTTTGTTACTAACTGTAACTTC
GTATGGAGAATCCCTGCGGCAACAGAAGCA|GTACTATTAGGACAGACCCCAAGACATTCA
TTACACTAGCACATGACGTGCACTCAAGTT|GGGACAGACTTGATTACGGACGAAAGGGAC
GACACACACTCGTTCTCAATAACGTCTTAT|CAGAAAGTCGGACTCTCGATCCGATCAATA
GGCACAAGCTAGCTCGGTTCCTCCCTGCAG|ATTGTGTAGATCTTGGTAGATCGCAACGAC
ACACTAGCACATGACGTGCACTCAAGTTAG|GACAGACTTGATTACGGACGAAAGGGACAG
AAGGGACAGACTTGATTCAGCCACGATATC|TTATTCGTAAGCGTCTCCGTCTTAAACTAG
AGGTGAGGTGCCGTTCATCTGAGTTTATTA|CATTTCATCACGAGCCCGCCATCAAGCTAG
TCTCCGTCTTAAACTAGAGACGGACGAAAG|GAGTATGGAGAATCCCTGCGGCAACAGAAG
AATCAAGGTCTGATACTCACAATCTTCTAG|GGACAGACTTGATTGGTTACAACGTACTCG
TTGAGATCAGTCGTCCAGGTTAATTGCCCA|CGAGGTGAGGTGCCGTTCATCTGAGTTTAT
CGCGGACTAGGCTCGTAGGCATGAGTTCAG|TCGAAGCCCGGGTTAGTGCTGTCGATCGCG
CTTGATTCAGCCACGATATCTCTAGGCAGC|GCGTCTCCGTCTTAAACTAGAGACGGACGA
AAGGGACAGACTTGATTATTCTTATAACTC|GTACGCTCGGCCCTACCGAGGCGGAACCGA
AAGGGACAGATAGAGACGGACGAAAGGGAC|CGCTTTCACATAAAATTGGAGACTATGTGG
AGAGACGGACGAAAGGGACAGACTTGATTT|GTCCAAATAGAGACGGACGAAAGGGACAGA
ATACTCACAATCTTCTAGAGACGGACGAAA|TTGGTTACAACGTACTCGGTCTGTAGAGTA
CCCACCACAGGGTGAGTTAGGTTTTGTTAC|AAAGGGACAGATAGAGACGGACGAAAGGGA
CATTCAAGTCTCGATTGAACAGTGTCTAGA|TCTCAATAACGTCTTATAACAGACGCTTAA
CTAGGCAGCAAACATGAGGGGTTGGCACAA|GACGGACGAAAGGGACAGACTTGATTGTGT
ACAGACTTGATTGACGAAAGGGACAGACTT|TAGGCAGCAAACATGAGGGGTTGGCACAAG
GCTGGAGACAGACACTGGAGCATTTCATCA|TGTGGGGTGATTGCCCTTCGGCCGCGGACT
TGATTTTAGAGACGGACGAAAGGGACAGAC|GACAGACTTGATTATTCTTATAACTCTTCC
GAGAATCCCTGCGGCAACAGAAGCACTCGG|ATTAGGACAGACCCCAAGACATTCAAGTCT
GGACAGACTTGATTTTAGAGACGGACGAAA|GACGAAAGGGACAGACTTGATTATTCTTAT
AGGGACAGACTTGATTTTAGAGACGGACGA|CGGACGAAAGGGACAGACTTGATTATTCTT
ATTGACAGTGTAATGGTGAGTATGGAGAAT|TAGCCCCGCACACGGATGCGTACTATTAGG
CGGACTCTCGATCCGATCAATAGAGACGGA|CGGACGAAAGGGACAGACTTGATTTTAGAG
TTGGAGACTATGTGGCATTTAATAGCGAAG|GAAAGGGACAGACTTGATTTTAGATGCCTT
CGAAAGGGACAGACTTGATTCAGCCACGAT|AACTTATTCGTAAGCGTCTCCGTCTTAAAC
TTGATTGGTTACAACGTACTCGGTCTGTAG|AGCTAGCTCGGTTCCTCCCTGCAGTGATGA
GGAGACTATGTGGCATTTAATAGCGAAGCT|AAGGGACAGACTTGATTTTAGATGCCTTAT
GATTTTAGAGACGGACGAAAGGGACAGACT|ACAGACTTGATTATTCTTATAACTCTTCCC
TCTAGAGACGGACGAAAGGGACAGATAGAG|GCTTAATTTAAGGTCCGCTTTCACATAAAA
AAGGGACAGACTTGATTTTAGAGACGGACG|ACGGACGAAAGGGACAGACTTGATTATTCT
AAGCTAGTCCAAATAGAGACGGACGAAAGG|TGAGTTCAGTCGTATGGTGAATATGCGTAC
TCGTCCAGGTTAATTGCCCAGAAAGTCGGA|TGCCGTTCATCTGAGTTTATTAGAGACGGA
GACGAGACAGCGGACTGCTAGAGACGGACG|CCACAGGGTGAGTTAGGTTTTGTTACTAAC
AAATAGAGACGGACGAAAGGGACAGACTTG|CGTATGGTGAATATGCGTACGCTCGGCCCT
ACTATTAGGACAGACCCCAAGACATTCAAG|GAAGTAGGGGACACACACTCGTTCTCAATA
CAACGTACTCGGTCTGTAGAGTAGAGACGG|TTCCTCCCTGCAGTGATGAGCACGCCTAGA
CAAGTTAGAGACGTAGAGACGGACGAAAGG|AGGGACAGACTTGATTCAGCCACGATATCT
ACGGACGAAAGGGACAGACTTGATTCACCG|TTATTCTTATAACTCTTCCCCGTTAGGAAT
CTAGAGACGGACGAAAGGGACAGACTTGAT|CCCTGCGGCAACAGAAGCACTCGGCCGATC
GCTTATTTGAGATCAGTCGTCCAGGTTAAT|TATTTGCGAGGTGAGGTGCCGTTCATCTGA
TTCGTAAGCGTCTCCGTCTTAAACTAGAGA|GTGTAATGGTGAGTATGGAGAATCCCTGCG
TGATAGAGACGGACGAAAGGGACAGACTTG|AGACTTGATTCACCGAAATCAAGTTCCACC
AGCAAACATGAGGGGTTGGCACAAGCTAGC|CGAAAGGGACAGACTTGATTGTGTAGATCT
CCGAAATCAAGTTCCACCAGCTGGAGACAG|AATCTGGAAACATTTCACCTGTGGGGTGAT
GGACGAAAGGGACAGACTTGATTCAGCCAC|ATTAACTTATTCGTAAGCGTCTCCGTCTTA
TCTGGGTATCCCGTTTGTCCCAGCCCACCA|TGAACAGTGTCTAGAGACGGACGAAAGGGA
AATCTTCTAGAGACGGACGAAAGGGACAGA|AACGTACTCGGTCTGTAGAGTAGAGACGGA
GTCGTCCAGGTTAATTGCCCAGAAAGTCGG|GTGCCGTTCATCTGAGTTTATTAGAGACGG
CTCGTTCTCAATAACGTCTTATAACAGACG|CGGACTCTCGATCCGATCAATAGAGACGGA
TTGATTAACTTATTCGTAAGCGTCTCCGTC|ACTTGATTGACAGTGTAATGGTGAGTATGG
ATCCCTGCGGCAACAGAAGCACTCGGCCGA|GGACAGACCCCAAGACATTCAAGTCTCGAT
ACGGACGAAAGGGACAGACTTGATTACGGA|TAGAGACGGACGAAAGGGACAGACTTGATT
CTTTCACATAAAATTGGAGACTATGTGGCA|GATAGAGACGGACGAAAGGGACAGACTTGA
GCCACGATATCTCTAGGCAGCAAACATGAG|TCTTAAACTAGAGACGGACGAAAGGGACAG
TGTAGAGTAGAGACGGACGAAAGGGACAGA|GATGAGCACGCCTAGAGACGGACGAAAGGG
GACTTGATTACACTAGCACATGACGTGCAC|GACGAAAGGGACAGACTTGATTACGGACGA
TAGATCTTGGTAGATCGCAACGACGAGACA|TATCCCGTTTGTCCCAGCCCACCACAGGGT
ACAGTGTCTAGAGACGGACGAAAGGGACAG|ACAGACGCTTAATTTAAGGTCCGCTTTCAC
GGCCGATCTGGGTATCCCGTTTGTCCCAGC|CTCGATTGAACAGTGTCTAGAGACGGACGA
TAGATCGCAACGACGAGACAGCGGACTGCT|GTCCCAGCCCACCACAGGGTGAGTTAGGTT
TAGAGACGGACGAAAGGGACAGACTTGATA|GATTTTAGAGACGGACGAAAGGGACAGACT
CAATCTTCTAGAGACGGACGAAAGGGACAG|CAACGTACTCGGTCTGTAGAGTAGAGACGG
ATTCGTAAGCGTCTCCGTCTTAAACTAGAG|AGTGTAATGGTGAGTATGGAGAATCCCTGC
CTAGCTCGGTTCCTCCCTGCAGTGATGAGC|GATCTTGGTAGATCGCAACGACGAGACAGC
CAGGTTAATTGCCCAGAAAGTCGGACTCTC|TTCATCTGAGTTTATTAGAGACGGACGAAA
AGAAAGTCGGACTCTCGATCCGATCAATAG|TTAGAGACGGACGAAAGGGACAGACTTGAT
GTTAATTGCCCAGAAAGTCGGACTCTCGAT|ATCTGAGTTTATTAGAGACGGACGAAAGGG
ACAATCTTCTAGAGACGGACGAAAGGGACA|ACAACGTACTCGGTCTGTAGAGTAGAGACG
CTTCCCCGTTAGGAATCTGGAAACATTTCA|ATTAACTACGACCAGCTGTAAGTCTGGAGT
GTTTTGTTACTAACTGTAACTTCTCGACCT|ACGAAAGGGACAGACTTGATTCTTGATTAT
CGACGAGACAGCGGACTGCTAGAGACGGAC|ACCACAGGGTGAGTTAGGTTTTGTTACTAA
CAGAAGCACTCGGCCGATCTGGGTATCCCG|GACATTCAAGTCTCGATTGAACAGTGTCTA
GGGACAGACTTGATTCTTGATTATCTAGTT|TGTGGCATTTAATAGCGAAGCTTATTTGAG
TATGTGGCATTTAATAGCGAAGCTTATTTG|CAGACTTGATTTTAGATGCCTTATTTGCGA
GCCGTTCATCTGAGTTTATTAGAGACGGAC|ACGAGCCCGCCATCAAGCTAGTCCAAATAG
CAATCAAGGTCTGATACTCACAATCTTCTA|GGGACAGACTTGATTGGTTACAACGTACTC
AGACGGACGAAAGGGACAGACTTGATTAAC|AGAGACGGACGAAAGGGACAGACTTGATTG
GGGACAGACTTGATTCACCGAAATCAAGTT|AACTCTTCCCCGTTAGGAATCTGGAAACAT
ACAGACTTGATTTTAGATGCCTTATTTGCG|AGTTCCACCAGCTGGAGACAGACACTGGAG
CAGACTTGATTACGGACGAAAGGGACAGAC|AGGGACAGACTTGATTAACTTATTCGTAAG
CTTGATTATTCTTATAACTCTTCCCCGTTA|CCCTACCGAGGCGGAACCGATTAACTACGA
ACCGTAGGGCCCCTCACTCAATCAAGGTCT|CAGACTTGATTGACGAAAGGGACAGACTTG
ACGAAAGGGACAGACTTGATTCAGCCACGA|TAACTTATTCGTAAGCGTCTCCGTCTTAAA
GTCCCAGCCCACCACAGGGTGAGTTAGGTT|ACGGACGAAAGGGACAGATAGAGACGGACG
CACCAGCTGGAGACAGACACTGGAGCATTT|TCACCTGTGGGGTGATTGCCCTTCGGCCGC
GCAGCAAACATGAGGGGTTGGCACAAGCTA|GACGAAAGGGACAGACTTGATTGTGTAGAT
AGACTTGATTGTGTAGATCTTGGTAGATCG|CGGCCGATCTGGGTATCCCGTTTGTCCCAG
TCGTTCTCAATAACGTCTTATAACAGACGC|GGACTCTCGATCCGATCAATAGAGACGGAC
CACTCGTTCTCAATAACGTCTTATAACAGA|GTCGGACTCTCGATCCGATCAATAGAGACG
AGGTCTGATACTCACAATCTTCTAGAGACG|GACTTGATTGGTTACAACGTACTCGGTCTG
CCTCACTCAATCAAGGTCTGATACTCACAA|GACGAAAGGGACAGACTTGATTGGTTACAA
TCGTAGGCATGAGTTCAGTCGTATGGTGAA|TTAGTGCTGTCGATCGCGGATGGGAAACGT
GACAGACTTGATTTTAGATGCCTTATTTGC|AAGTTCCACCAGCTGGAGACAGACACTGGA
TTGATTACGGACGAAAGGGACAGACTTGAT|CAGACTTGATTAACTTATTCGTAAGCGTCT
CATGAGTTCAGTCGTATGGTGAATATGCGT|TGTCGATCGCGGATGGGAAACGTTTGTACA
CGAAAGGGACAGACTTGATTAACTTATTCG|GACGAAAGGGACAGACTTGATTGACAGTGT
TAAGGTCCGCTTTCACATAAAATTGGAGAC|GACAGACTTGATAGAGACGGACGAAAGGGA
AGACTTGATTTTAGAGACGGACGAAAGGGA|AAAGGGACAGACTTGATTATTCTTATAACT
CGCAACGACGAGACAGCGGACTGCTAGAGA|AGCCCACCACAGGGTGAGTTAGGTTTTGTT
TTTTAGAGACGGACGAAAGGGACAGACTTG|AGACTTGATTATTCTTATAACTCTTCCCCG
ACATGAGGGGTTGGCACAAGCTAGCTCGGT|GGGACAGACTTGATTGTGTAGATCTTGGTA
ACCTGTGGGGTGATTGCCCTTCGGCCGCGG|TAGCTGTACGTGTATACCGCGGGATTCGAA
CCCGTTTGTCCCAGCCCACCACAGGGTGAG|TCTAGAGACGGACGAAAGGGACAGATAGAG
GTCTAGAGACGGACGAAAGGGACAGATAGA|CGCTTAATTTAAGGTCCGCTTTCACATAAA
ACTCTTCCCCGTTAGGAATCTGGAAACATT|CCGATTAACTACGACCAGCTGTAAGTCTGG
ACGAAAGGGACAGACTTGATTGACAGTGTA|AACTGTAACTTCTCGACCTAGCCCCGCACA
GCACGCCTAGAGACGGACGAAAGGGACAGA|GCGGACTGCTAGAGACGGACGAAAGGGACA
ATCTGGAAACATTTCACCTGTGGGGTGATT|GCTGTAAGTCTGGAGTAGCTGTACGTGTAT
AGGGACAGACTTGATTCAGCCACGATATCT|TATTCGTAAGCGTCTCCGTCTTAAACTAGA
AAAGTCGGACTCTCGATCCGATCAATAGAG|AGAGACGGACGAAAGGGACAGACTTGATTT
TGAGGGGTTGGCACAAGCTAGCTCGGTTCC|ACAGACTTGATTGTGTAGATCTTGGTAGAT
CTTCTCGACCTAGCCCCGCACACGGATGCG|TTCTTGATTATCTAGTTGCGTACTATTTGA
TAACTTCTCGACCTAGCCCCGCACACGGAT|TGATTCTTGATTATCTAGTTGCGTACTATT
ATTATTCTTATAACTCTTCCCCGTTAGGAA|ACCGAGGCGGAACCGATTAACTACGACCAG
AACTTCTCGACCTAGCCCCGCACACGGATG|GATTCTTGATTATCTAGTTGCGTACTATTT
TTCATCTGAGTTTATTAGAGACGGACGAAA|GCCCGCCATCAAGCTAGTCCAAATAGAGAC
TAGAGACGGACGAAAGGGACAGACTTGATT|TTTGTTACTAACTGTAACTTCTCGACCTAG
AAGCTTATTTGAGATCAGTCGTCCAGGTTA|CTTATTTGCGAGGTGAGGTGCCGTTCATCT
GAAAGGGACAGACTTGATTGACGAAAGGGA|ATATCTCTAGGCAGCAAACATGAGGGGTTG
ACAGGGTGAGTTAGGTTTTGTTACTAACTG|ACAGATAGAGACGGACGAAAGGGACAGACT
ATGTGGCATTTAATAGCGAAGCTTATTTGA|AGACTTGATTTTAGATGCCTTATTTGCGAG
AAGACATTCAAGTCTCGATTGAACAGTGTC|TCGTTCTCAATAACGTCTTATAACAGACGC
TTACGGACGAAAGGGACAGACTTGATTCAG|CTTGATTAACTTATTCGTAAGCGTCTCCGT
CAGCAAACATGAGGGGTTGGCACAAGCTAG|ACGAAAGGGACAGACTTGATTGTGTAGATC
TCTTCCCCGTTAGGAATCTGGAAACATTTC|GATTAACTACGACCAGCTGTAAGTCTGGAG
ACGAAAGGGACAGACTTGATTATTCTTATA|ATGCGTACGCTCGGCCCTACCGAGGCGGAA
ACTCGGTCTGTAGAGTAGAGACGGACGAAA|CCTGCAGTGATGAGCACGCCTAGAGACGGA
TAAACTAGAGACGGACGAAAGGGACAGACT|GAATCCCTGCGGCAACAGAAGCACTCGGCC
CAGACCCCAAGACATTCAAGTCTCGATTGA|ACACACACTCGTTCTCAATAACGTCTTATA
AGGGACAGACTTGATTACGGACGAAAGGGA|ACGAAAGGGACAGACTTGATTAACTTATTC
AGGGACAGACTTGATTGACGAAAGGGACAG|TCTCTAGGCAGCAAACATGAGGGGTTGGCA
AGATGCCTTATTTGCGAGGTGAGGTGCCGT|GAGACAGACACTGGAGCATTTCATCACGAG
AGACTTGATTCACCGAAATCAAGTTCCACC|TTCCCCGTTAGGAATCTGGAAACATTTCAC
GGACTCTCGATCCGATCAATAGAGACGGAC|GGACGAAAGGGACAGACTTGATTTTAGAGA
TCACATAAAATTGGAGACTATGTGGCATTT|AGAGACGGACGAAAGGGACAGACTTGATTT
CGGACTAGGCTCGTAGGCATGAGTTCAGTC|GAAGCCCGGGTTAGTGCTGTCGATCGCGGA
CGGACGAAAGGGACAGACTTGATTCACCGA|TATTCTTATAACTCTTCCCCGTTAGGAATC
AGTAGGGGACACACACTCGTTCTCAATAAC|AATTGCCCAGAAAGTCGGACTCTCGATCCG
ATGGAGAATCCCTGCGGCAACAGAAGCACT|ACTATTAGGACAGACCCCAAGACATTCAAG
TCTTATAACAGACGCTTAATTTAAGGTCCG|TCAATAGAGACGGACGAAAGGGACAGACTT
AAAGGGACAGACTTGATTTTAGAGACGGAC|GACGGACGAAAGGGACAGACTTGATTATTC
TTCCCCGTTAGGAATCTGGAAACATTTCAC|TTAACTACGACCAGCTGTAAGTCTGGAGTA
GGACAGACTTGATAGAGACGGACGAAAGGG|GAAAGGGACAGACTTGATTCACCGAAATCA
AGGGACAGACTTGATTAACTTATTCGTAAG|AAAGGGACAGACTTGATTGACAGTGTAATG
CACTCAAGTTAGAGACGTAGAGACGGACGA|CGAAAGGGACAGACTTGATTCAGCCACGAT
TCAGTCGTCCAGGTTAATTGCCCAGAAAGT|GAGGTGCCGTTCATCTGAGTTTATTAGAGA
TGATTAACTTATTCGTAAGCGTCTCCGTCT|CTTGATTGACAGTGTAATGGTGAGTATGGA
GCACATGACGTGCACTCAAGTTAGAGACGT|CTTGATTACGGACGAAAGGGACAGACTTGA
AAAGGGACAGACTTGATTATTCTTATAACT|CGTACGCTCGGCCCTACCGAGGCGGAACCG
CGCTTTCACATAAAATTGGAGACTATGTGG|TTGATAGAGACGGACGAAAGGGACAGACTT
GGACAGACTTGATTGTGTAGATCTTGGTAG|CACTCGGCCGATCTGGGTATCCCGTTTGTC
CAATAACGTCTTATAACAGACGCTTAATTT|CGATCCGATCAATAGAGACGGACGAAAGGG
TAGTCCAAATAGAGACGGACGAAAGGGACA|TTCAGTCGTATGGTGAATATGCGTACGCTC
GCACACGGATGCGTACTATTAGGACAGACC|GCGTACTATTTGACGAAGTAGGGGACACAC
CGAAAGGGACAGACTTGATTACGGACGAAA|ACGGACGAAAGGGACAGACTTGATTAACTT
GACGAAAGGGACAGACTTGATTGACGAAAG|ACGATATCTCTAGGCAGCAAACATGAGGGG
CGTAGGGCCCCTCACTCAATCAAGGTCTGA|GACTTGATTGACGAAAGGGACAGACTTGAT
ACGAAAGGGACAGACTTGATTCACCGAAAT|TCTTATAACTCTTCCCCGTTAGGAATCTGG
GACGGACGAAAGGGACAGACTTGATTGACG|AGCCACGATATCTCTAGGCAGCAAACATGA
GCAGTGATGAGCACGCCTAGAGACGGACGA|CGACGAGACAGCGGACTGCTAGAGACGGAC
CGTTCATCTGAGTTTATTAGAGACGGACGA|GAGCCCGCCATCAAGCTAGTCCAAATAGAG
TTTAGAGACGGACGAAAGGGACAGACTTGA|GACTTGATTATTCTTATAACTCTTCCCCGT
GTTAGGAATCTGGAAACATTTCACCTGTGG|ACGACCAGCTGTAAGTCTGGAGTAGCTGTA
TGAGTTTATTAGAGACGGACGAAAGGGACA|CATCAAGCTAGTCCAAATAGAGACGGACGA
TGTAACTTCTCGACCTAGCCCCGCACACGG|CTTGATTCTTGATTATCTAGTTGCGTACTA
AGTGTAATGGTGAGTATGGAGAATCCCTGC|CGCACACGGATGCGTACTATTAGGACAGAC
TAGAGACGGACGAAAGGGACAGACTTGATT|CTTGATTATTCTTATAACTCTTCCCCGTTA
ACGGACGAAAGGGACAGACTTGATTGACAG|TACTAACTGTAACTTCTCGACCTAGCCCCG
CCAGGTTAATTGCCCAGAAAGTCGGACTCT|GTTCATCTGAGTTTATTAGAGACGGACGAA
CCCCTCACTCAATCAAGGTCTGATACTCAC|TTGACGAAAGGGACAGACTTGATTGGTTAC
GCGTACTATTTGACGAAGTAGGGGACACAC|ATCAGTCGTCCAGGTTAATTGCCCAGAAAG
CTTGATTAACTTATTCGTAAGCGTCTCCGT|GACTTGATTGACAGTGTAATGGTGAGTATG
GTGTAATGGTGAGTATGGAGAATCCCTGCG|GCACACGGATGCGTACTATTAGGACAGACC
CGAAAGGGACAGACTTGATTGACAGTGTAA|ACTGTAACTTCTCGACCTAGCCCCGCACAC
GTCTTAAACTAGAGACGGACGAAAGGGACA|TGGAGAATCCCTGCGGCAACAGAAGCACTC
CGATCTGGGTATCCCGTTTGTCCCAGCCCA|GATTGAACAGTGTCTAGAGACGGACGAAAG
CGAAAGGGACAGACTTGATTTTAGATGCCT|CGAAATCAAGTTCCACCAGCTGGAGACAGA
TTGATTGTGTAGATCTTGGTAGATCGCAAC|CGATCTGGGTATCCCGTTTGTCCCAGCCCA
TAGGGCCCCTCACTCAATCAAGGTCTGATA|CTTGATTGACGAAAGGGACAGACTTGATTG
GACTTGATTTTAGAGACGGACGAAAGGGAC|AAGGGACAGACTTGATTATTCTTATAACTC
ACTAGCACATGACGTGCACTCAAGTTAGAG|CAGACTTGATTACGGACGAAAGGGACAGAC
CTTGATTATCTAGTTGCGTACTATTTGACG|CGAAGCTTATTTGAGATCAGTCGTCCAGGT
GACAGACTTGATTGACGAAAGGGACAGACT|CTAGGCAGCAAACATGAGGGGTTGGCACAA
GATCAATAGAGACGGACGAAAGGGACAGAC|AGACTTGATTTTAGAGACGGACGAAAGGGA
CTTGATTGACAGTGTAATGGTGAGTATGGA|GACCTAGCCCCGCACACGGATGCGTACTAT
GAGTATGGAGAATCCCTGCGGCAACAGAAG|GCGTACTATTAGGACAGACCCCAAGACATT
GAAAGGGACAGATAGAGACGGACGAAAGGG|TCCGCTTTCACATAAAATTGGAGACTATGT
CTGCGGCAACAGAAGCACTCGGCCGATCTG|AGACCCCAAGACATTCAAGTCTCGATTGAA
ATTGACGAAAGGGACAGACTTGATTGGTTA|AACATGAGGGGTTGGCACAAGCTAGCTCGG
GACGGACGAAAGGGACAGACTTGATTATTC|TGAATATGCGTACGCTCGGCCCTACCGAGG
CAAACATGAGGGGTTGGCACAAGCTAGCTC|AAAGGGACAGACTTGATTGTGTAGATCTTG
TAGTTGCGTACTATTTGACGAAGTAGGGGA|TTGAGATCAGTCGTCCAGGTTAATTGCCCA
AGAGACGGACGAAAGGGACAGACTTGATTG|TTCAGCCACGATATCTCTAGGCAGCAAACA
TTTGAGATCAGTCGTCCAGGTTAATTGCCC|GCGAGGTGAGGTGCCGTTCATCTGAGTTTA
ACGGACGAAAGGGACAGACTTGATTCTTGA|TTGGAGACTATGTGGCATTTAATAGCGAAG
ACTCGTTCTCAATAACGTCTTATAACAGAC|TCGGACTCTCGATCCGATCAATAGAGACGG
GGACAGACTTGATTGGTTACAACGTACTCG|TTGGCACAAGCTAGCTCGGTTCCTCCCTGC
CAGCTGGAGACAGACACTGGAGCATTTCAT|CCTGTGGGGTGATTGCCCTTCGGCCGCGGA
CAGTGTAATGGTGAGTATGGAGAATCCCTG|CCGCACACGGATGCGTACTATTAGGACAGA
CTTATTTGAGATCAGTCGTCCAGGTTAATT|ATTTGCGAGGTGAGGTGCCGTTCATCTGAG
AAACTAGAGACGGACGAAAGGGACAGACTT|AATCCCTGCGGCAACAGAAGCACTCGGCCG
GAGACGGACGAAAGGGACAGACTTGATTGA|TCAGCCACGATATCTCTAGGCAGCAAACAT
CTTCGGCCGCGGACTAGGCTCGTAGGCATG|GCGGGATTCGAAGCCCGGGTTAGTGCTGTC
CCCCAAGACATTCAAGTCTCGATTGAACAG|ACACTCGTTCTCAATAACGTCTTATAACAG
GCAACGACGAGACAGCGGACTGCTAGAGAC|GCCCACCACAGGGTGAGTTAGGTTTTGTTA
TTGGTAGATCGCAACGACGAGACAGCGGAC|GTTTGTCCCAGCCCACCACAGGGTGAGTTA
CACATGACGTGCACTCAAGTTAGAGACGTA|TTGATTACGGACGAAAGGGACAGACTTGAT
TGGAGACAGACACTGGAGCATTTCATCACG|TGGGGTGATTGCCCTTCGGCCGCGGACTAG
TCCAGGTTAATTGCCCAGAAAGTCGGACTC|CGTTCATCTGAGTTTATTAGAGACGGACGA
AGGTCCGCTTTCACATAAAATTGGAGACTA|CAGACTTGATAGAGACGGACGAAAGGGACA
GGTAGATCGCAACGACGAGACAGCGGACTG|TTGTCCCAGCCCACCACAGGGTGAGTTAGG
TTAGAGACGGACGAAAGGGACAGACTTGAT|TAGTCCAAATAGAGACGGACGAAAGGGACA
GTCTGTAGAGTAGAGACGGACGAAAGGGAC|AGTGATGAGCACGCCTAGAGACGGACGAAA
GTAGAGACGGACGAAAGGGACAGACTTGAT|CACGCCTAGAGACGGACGAAAGGGACAGAC
CAGACTTGATTAACTTATTCGTAAGCGTCT|GACAGACTTGATTGACAGTGTAATGGTGAG
GTAGAGACGGACGAAAGGGACAGACTTGAT|GATTCAGCCACGATATCTCTAGGCAGCAAA
ACTATGTGGCATTTAATAGCGAAGCTTATT|GACAGACTTGATTTTAGATGCCTTATTTGC
CGAAGTAGGGGACACACACTCGTTCTCAAT|GTTAATTGCCCAGAAAGTCGGACTCTCGAT
GTAGATCTTGGTAGATCGCAACGACGAGAC|GTATCCCGTTTGTCCCAGCCCACCACAGGG
GAGACGGACGAAAGGGACAGACTTGATTAT|GGTGAATATGCGTACGCTCGGCCCTACCGA
AAGGGACAGACTTGATTACACTAGCACATG|TAGAGACGGACGAAAGGGACAGACTTGATT
GTAGGGGACACACACTCGTTCTCAATAACG|ATTGCCCAGAAAGTCGGACTCTCGATCCGA
AACTTATTCGTAAGCGTCTCCGTCTTAAAC|TTGACAGTGTAATGGTGAGTATGGAGAATC
CGATATCTCTAGGCAGCAAACATGAGGGGT|AAACTAGAGACGGACGAAAGGGACAGACTT
AAAGGGACAGACTTGATTCAGCCACGATAT|CTTATTCGTAAGCGTCTCCGTCTTAAACTA
GATACTCACAATCTTCTAGAGACGGACGAA|ATTGGTTACAACGTACTCGGTCTGTAGAGT
CGTCTTATAACAGACGCTTAATTTAAGGTC|GATCAATAGAGACGGACGAAAGGGACAGAC
CGGACGAAAGGGACAGACTTGATTATTCTT|AATATGCGTACGCTCGGCCCTACCGAGGCG
AGACGGACGAAAGGGACAGACTTGATTTTA|CCAAATAGAGACGGACGAAAGGGACAGACT
TAATAGCGAAGCTTATTTGAGATCAGTCGT|TTAGATGCCTTATTTGCGAGGTGAGGTGCC
GGACGAAAGGGACAGACTTGATTATTCTTA|ATATGCGTACGCTCGGCCCTACCGAGGCGG
GACTTGATTAACTTATTCGTAAGCGTCTCC|CAGACTTGATTGACAGTGTAATGGTGAGTA
GACAGACTTGATTCTTGATTATCTAGTTGC|TGGCATTTAATAGCGAAGCTTATTTGAGAT
ACTCGGCCGATCTGGGTATCCCGTTTGTCC|AAGTCTCGATTGAACAGTGTCTAGAGACGG
AATAGCGAAGCTTATTTGAGATCAGTCGTC|TAGATGCCTTATTTGCGAGGTGAGGTGCCG
GACGAAAGGGACAGACTTGATTATTCTTAT|TATGCGTACGCTCGGCCCTACCGAGGCGGA
AAAGGGACAGACTTGATTACGGACGAAAGG|GGACGAAAGGGACAGACTTGATTAACTTAT
CAGACTTGATAGAGACGGACGAAAGGGACA|AGGGACAGACTTGATTCACCGAAATCAAGT
CTAGCCCCGCACACGGATGCGTACTATTAG|ATCTAGTTGCGTACTATTTGACGAAGTAGG
TCTCGATCCGATCAATAGAGACGGACGAAA|GAAAGGGACAGACTTGATTTTAGAGACGGA
TTTGTTACTAACTGTAACTTCTCGACCTAG|GAAAGGGACAGACTTGATTCTTGATTATCT
AGCGAAGCTTATTTGAGATCAGTCGTCCAG|ATGCCTTATTTGCGAGGTGAGGTGCCGTTC
GTTTGTCCCAGCCCACCACAGGGTGAGTTA|AGAGACGGACGAAAGGGACAGATAGAGACG
CATTTCACCTGTGGGGTGATTGCCCTTCGG|CTGGAGTAGCTGTACGTGTATACCGCGGGA
ATTTTAGAGACGGACGAAAGGGACAGACTT|CAGACTTGATTATTCTTATAACTCTTCCCC
ACTGTAACTTCTCGACCTAGCCCCGCACAC|GACTTGATTCTTGATTATCTAGTTGCGTAC
CTGTGGGGTGATTGCCCTTCGGCCGCGGAC|GCTGTACGTGTATACCGCGGGATTCGAAGC
AACATTTCACCTGTGGGGTGATTGCCCTTC|GTCTGGAGTAGCTGTACGTGTATACCGCGG
ATTCAAGTCTCGATTGAACAGTGTCTAGAG|CTCAATAACGTCTTATAACAGACGCTTAAT
CACCACAGGGTGAGTTAGGTTTTGTTACTA|AGGGACAGATAGAGACGGACGAAAGGGACA
TATGGAGAATCCCTGCGGCAACAGAAGCAC|TACTATTAGGACAGACCCCAAGACATTCAA
GGGTGATTGCCCTTCGGCCGCGGACTAGGC|ACGTGTATACCGCGGGATTCGAAGCCCGGG
TTGCGTACTATTTGACGAAGTAGGGGACAC|AGATCAGTCGTCCAGGTTAATTGCCCAGAA
GGACAGACTTGATTAACTTATTCGTAAGCG|AGGGACAGACTTGATTGACAGTGTAATGGT
CTTGATTGGTTACAACGTACTCGGTCTGTA|AAGCTAGCTCGGTTCCTCCCTGCAGTGATG
GGACGAAAGGGACAGACTTGATTTTAGATG|CACCGAAATCAAGTTCCACCAGCTGGAGAC
GCTAGCTCGGTTCCTCCCTGCAGTGATGAG|AGATCTTGGTAGATCGCAACGACGAGACAG
ATATCTCTAGGCAGCAAACATGAGGGGTTG|ACTAGAGACGGACGAAAGGGACAGACTTGA
GCCTAGAGACGGACGAAAGGGACAGACTTG|ACTGCTAGAGACGGACGAAAGGGACAGACT
CATTTAATAGCGAAGCTTATTTGAGATCAG|GATTTTAGATGCCTTATTTGCGAGGTGAGG
GACGGACGAAAGGGACAGACTTGATTCTTG|ATTGGAGACTATGTGGCATTTAATAGCGAA
AGTATGGAGAATCCCTGCGGCAACAGAAGC|CGTACTATTAGGACAGACCCCAAGACATTC
GACGAAAGGGACAGACTTGATAGAGACGGA|AGACGGACGAAAGGGACAGACTTGATTCAC
TGCACTCAAGTTAGAGACGTAGAGACGGAC|GACGAAAGGGACAGACTTGATTCAGCCACG
CCGTTCATCTGAGTTTATTAGAGACGGACG|CGAGCCCGCCATCAAGCTAGTCCAAATAGA
TTATTTGCGAGGTGAGGTGCCGTTCATCTG|ACACTGGAGCATTTCATCACGAGCCCGCCA
GCATTTCATCACGAGCCCGCCATCAAGCTA|GGCCGCGGACTAGGCTCGTAGGCATGAGTT
TCGATCCGATCAATAGAGACGGACGAAAGG|AAGGGACAGACTTGATTTTAGAGACGGACG
AGGCAGCAAACATGAGGGGTTGGCACAAGC|CGGACGAAAGGGACAGACTTGATTGTGTAG
CCGCTTTCACATAAAATTGGAGACTATGTG|CTTGATAGAGACGGACGAAAGGGACAGACT
CTGGAAACATTTCACCTGTGGGGTGATTGC|TGTAAGTCTGGAGTAGCTGTACGTGTATAC
AGACATTCAAGTCTCGATTGAACAGTGTCT|CGTTCTCAATAACGTCTTATAACAGACGCT
TATTTGCGAGGTGAGGTGCCGTTCATCTGA|CACTGGAGCATTTCATCACGAGCCCGCCAT
GCCGCGGACTAGGCTCGTAGGCATGAGTTC|ATTCGAAGCCCGGGTTAGTGCTGTCGATCG
AGACGTAGAGACGGACGAAAGGGACAGACT|ACTTGATTCAGCCACGATATCTCTAGGCAG
GTGATTGCCCTTCGGCCGCGGACTAGGCTC|GTGTATACCGCGGGATTCGAAGCCCGGGTT
GGACGAAAGGGACAGACTTGATTAACTTAT|ACGGACGAAAGGGACAGACTTGATTGACAG
TATAACAGACGCTTAATTTAAGGTCCGCTT|ATAGAGACGGACGAAAGGGACAGACTTGAT
CCGTTTGTCCCAGCCCACCACAGGGTGAGT|CTAGAGACGGACGAAAGGGACAGATAGAGA
GGCCCCTCACTCAATCAAGGTCTGATACTC|GATTGACGAAAGGGACAGACTTGATTGGTT
GTTAGGTTTTGTTACTAACTGTAACTTCTC|GACGGACGAAAGGGACAGACTTGATTCTTG
GGGACAGACTTGATAGAGACGGACGAAAGG|CGAAAGGGACAGACTTGATTCACCGAAATC
GACAGACACTGGAGCATTTCATCACGAGCC|GTGATTGCCCTTCGGCCGCGGACTAGGCTC
GAGACGGACGAAAGGGACAGACTTGATAGA|TTTTAGAGACGGACGAAAGGGACAGACTTG
AGGGACAGACTTGATTATTCTTATAACTCT|TACGCTCGGCCCTACCGAGGCGGAACCGAT
AGACCCCAAGACATTCAAGTCTCGATTGAA|CACACACTCGTTCTCAATAACGTCTTATAA
CATGACGTGCACTCAAGTTAGAGACGTAGA|GATTACGGACGAAAGGGACAGACTTGATTC
ACGTGCACTCAAGTTAGAGACGTAGAGACG|ACGGACGAAAGGGACAGACTTGATTCAGCC
TTAAGGTCCGCTTTCACATAAAATTGGAGA|GGACAGACTTGATAGAGACGGACGAAAGGG
GACTCTCGATCCGATCAATAGAGACGGACG|GACGAAAGGGACAGACTTGATTTTAGAGAC
GACAGACTTGATTCAGCCACGATATCTCTA|TCGTAAGCGTCTCCGTCTTAAACTAGAGAC
GGTCTGATACTCACAATCTTCTAGAGACGG|ACTTGATTGGTTACAACGTACTCGGTCTGT
TCGGTCTGTAGAGTAGAGACGGACGAAAGG|TGCAGTGATGAGCACGCCTAGAGACGGACG
GACAGACTTGATAGAGACGGACGAAAGGGA|AAAGGGACAGACTTGATTCACCGAAATCAA
CCAGCCCACCACAGGGTGAGTTAGGTTTTG|GACGAAAGGGACAGATAGAGACGGACGAAA
TGACGAAAGGGACAGACTTGATTGGTTACA|CATGAGGGGTTGGCACAAGCTAGCTCGGTT
CACGGATGCGTACTATTAGGACAGACCCCA|TACTATTTGACGAAGTAGGGGACACACACT
CAGACTTGATTGGTTACAACGTACTCGGTC|GCACAAGCTAGCTCGGTTCCTCCCTGCAGT
CTGGGTATCCCGTTTGTCCCAGCCCACCAC|GAACAGTGTCTAGAGACGGACGAAAGGGAC
GAAACATTTCACCTGTGGGGTGATTGCCCT|AAGTCTGGAGTAGCTGTACGTGTATACCGC
GAGTAGAGACGGACGAAAGGGACAGACTTG|AGCACGCCTAGAGACGGACGAAAGGGACAG
GTGCACTCAAGTTAGAGACGTAGAGACGGA|GGACGAAAGGGACAGACTTGATTCAGCCAC
AGGGACAGATAGAGACGGACGAAAGGGACA|GCTTTCACATAAAATTGGAGACTATGTGGC
CCGCCATCAAGCTAGTCCAAATAGAGACGG|CGTAGGCATGAGTTCAGTCGTATGGTGAAT
AGGGACAGACTTGATTACACTAGCACATGA|AGAGACGGACGAAAGGGACAGACTTGATTA
TGATTGCCCTTCGGCCGCGGACTAGGCTCG|TGTATACCGCGGGATTCGAAGCCCGGGTTA
GGATGCGTACTATTAGGACAGACCCCAAGA|TATTTGACGAAGTAGGGGACACACACTCGT
ACGAAAGGGACAGACTTGATTACGGACGAA|GACGGACGAAAGGGACAGACTTGATTAACT
TTGATTCTTGATTATCTAGTTGCGTACTAT|TAATAGCGAAGCTTATTTGAGATCAGTCGT
AGACTTGATTGACAGTGTAATGGTGAGTAT|CTCGACCTAGCCCCGCACACGGATGCGTAC
ATTGAACAGTGTCTAGAGACGGACGAAAGG|TTATAACAGACGCTTAATTTAAGGTCCGCT
GACGTGCACTCAAGTTAGAGACGTAGAGAC|TACGGACGAAAGGGACAGACTTGATTCAGC
TAATGGTGAGTATGGAGAATCCCTGCGGCA|CACGGATGCGTACTATTAGGACAGACCCCA
ATTTAAGGTCCGCTTTCACATAAAATTGGA|AGGGACAGACTTGATAGAGACGGACGAAAG
TACTATTTGACGAAGTAGGGGACACACACT|AGTCGTCCAGGTTAATTGCCCAGAAAGTCG
GTCCAAATAGAGACGGACGAAAGGGACAGA|CAGTCGTATGGTGAATATGCGTACGCTCGG
TCACGAGCCCGCCATCAAGCTAGTCCAAAT|ACTAGGCTCGTAGGCATGAGTTCAGTCGTA
AAAGGGACAGACTTGATTCTTGATTATCTA|CTATGTGGCATTTAATAGCGAAGCTTATTT
AGGGACAGACTTGATAGAGACGGACGAAAG|ACGAAAGGGACAGACTTGATTCACCGAAAT
TAAGCGTCTCCGTCTTAAACTAGAGACGGA|AATGGTGAGTATGGAGAATCCCTGCGGCAA
AGGTTTTGTTACTAACTGTAACTTCTCGAC|GGACGAAAGGGACAGACTTGATTCTTGATT
GTGAGGTGCCGTTCATCTGAGTTTATTAGA|TTTCATCACGAGCCCGCCATCAAGCTAGTC
CGAAAGGGACAGACTTGATTGGTTACAACG|GAGGGGTTGGCACAAGCTAGCTCGGTTCCT
AATCTGGAAACATTTCACCTGTGGGGTGAT|AGCTGTAAGTCTGGAGTAGCTGTACGTGTA
AAGTCTCGATTGAACAGTGTCTAGAGACGG|ATAACGTCTTATAACAGACGCTTAATTTAA
GGCAACAGAAGCACTCGGCCGATCTGGGTA|CCCAAGACATTCAAGTCTCGATTGAACAGT
TGATTATCTAGTTGCGTACTATTTGACGAA|AAGCTTATTTGAGATCAGTCGTCCAGGTTA
TTATTTGAGATCAGTCGTCCAGGTTAATTG|TTTGCGAGGTGAGGTGCCGTTCATCTGAGT
TCCCCGTTAGGAATCTGGAAACATTTCACC|TAACTACGACCAGCTGTAAGTCTGGAGTAG
TAGAGACGTAGAGACGGACGAAAGGGACAG|CAGACTTGATTCAGCCACGATATCTCTAGG
ACGGACGAAAGGGACAGACTTGATTAACTT|AGACGGACGAAAGGGACAGACTTGATTGAC
CACACTCGTTCTCAATAACGTCTTATAACA|AAGTCGGACTCTCGATCCGATCAATAGAGA
ACAGACACTGGAGCATTTCATCACGAGCCC|TGATTGCCCTTCGGCCGCGGACTAGGCTCG
CAGACTTGATTACACTAGCACATGACGTGC|CGGACGAAAGGGACAGACTTGATTACGGAC
TACACTAGCACATGACGTGCACTCAAGTTA|GGACAGACTTGATTACGGACGAAAGGGACA
CAAATAGAGACGGACGAAAGGGACAGACTT|TCGTATGGTGAATATGCGTACGCTCGGCCC
TTGTGTAGATCTTGGTAGATCGCAACGACG|CTGGGTATCCCGTTTGTCCCAGCCCACCAC
GATCCGATCAATAGAGACGGACGAAAGGGA|GGGACAGACTTGATTTTAGAGACGGACGAA
GGTCTGTAGAGTAGAGACGGACGAAAGGGA|CAGTGATGAGCACGCCTAGAGACGGACGAA
GTATCCCGTTTGTCCCAGCCCACCACAGGG|AGTGTCTAGAGACGGACGAAAGGGACAGAT
GGTTTTGTTACTAACTGTAACTTCTCGACC|GACGAAAGGGACAGACTTGATTCTTGATTA
CCGTCTTAAACTAGAGACGGACGAAAGGGA|TATGGAGAATCCCTGCGGCAACAGAAGCAC
TAACTTATTCGTAAGCGTCTCCGTCTTAAA|ATTGACAGTGTAATGGTGAGTATGGAGAAT
CCACCACAGGGTGAGTTAGGTTTTGTTACT|AAGGGACAGATAGAGACGGACGAAAGGGAC
AGACTTGATAGAGACGGACGAAAGGGACAG|GGGACAGACTTGATTCACCGAAATCAAGTT
GGACGAAAGGGACAGACTTGATTGACAGTG|CTAACTGTAACTTCTCGACCTAGCCCCGCA
GGTGCCGTTCATCTGAGTTTATTAGAGACG|ATCACGAGCCCGCCATCAAGCTAGTCCAAA
GTCTGATACTCACAATCTTCTAGAGACGGA|CTTGATTGGTTACAACGTACTCGGTCTGTA
ACGAAAGGGACAGACTTGATTACACTAGCA|AGAGTAGAGACGGACGAAAGGGACAGACTT
AAGCGTCTCCGTCTTAAACTAGAGACGGAC|ATGGTGAGTATGGAGAATCCCTGCGGCAAC
AAACATTTCACCTGTGGGGTGATTGCCCTT|AGTCTGGAGTAGCTGTACGTGTATACCGCG
GATTGACGAAAGGGACAGACTTGATTGGTT|AAACATGAGGGGTTGGCACAAGCTAGCTCG
TTTGACGAAGTAGGGGACACACACTCGTTC|TCCAGGTTAATTGCCCAGAAAGTCGGACTC
TGGAGACTATGTGGCATTTAATAGCGAAGC|AAAGGGACAGACTTGATTTTAGATGCCTTA
GACAGACTTGATTCACCGAAATCAAGTTCC|CTCTTCCCCGTTAGGAATCTGGAAACATTT
GACACTGGAGCATTTCATCACGAGCCCGCC|TTGCCCTTCGGCCGCGGACTAGGCTCGTAG
GAAAGGGACAGACTTGATTGACAGTGTAAT|CTGTAACTTCTCGACCTAGCCCCGCACACG
ACGGACGAAAGGGACAGACTTGATTATTCT|GAATATGCGTACGCTCGGCCCTACCGAGGC
TTGATTGACAGTGTAATGGTGAGTATGGAG|ACCTAGCCCCGCACACGGATGCGTACTATT
AAGGGACAGACTTGATTGACGAAAGGGACA|ATCTCTAGGCAGCAAACATGAGGGGTTGGC
AATTTAAGGTCCGCTTTCACATAAAATTGG|AAGGGACAGACTTGATAGAGACGGACGAAA
TCTGAGTTTATTAGAGACGGACGAAAGGGA|GCCATCAAGCTAGTCCAAATAGAGACGGAC
TTAGGTTTTGTTACTAACTGTAACTTCTCG|ACGGACGAAAGGGACAGACTTGATTCTTGA
ACCACAGGGTGAGTTAGGTTTTGTTACTAA|GGGACAGATAGAGACGGACGAAAGGGACAG
AGCTAGCTCGGTTCCTCCCTGCAGTGATGA|TAGATCTTGGTAGATCGCAACGACGAGACA
GGCCGCGGACTAGGCTCGTAGGCATGAGTT|GATTCGAAGCCCGGGTTAGTGCTGTCGATC
ATTGGTTACAACGTACTCGGTCTGTAGAGT|TAGCTCGGTTCCTCCCTGCAGTGATGAGCA
ACGAAGTAGGGGACACACACTCGTTCTCAA|GGTTAATTGCCCAGAAAGTCGGACTCTCGA
CCTGTGGGGTGATTGCCCTTCGGCCGCGGA|AGCTGTACGTGTATACCGCGGGATTCGAAG
TAGGGGACACACACTCGTTCTCAATAACGT|TTGCCCAGAAAGTCGGACTCTCGATCCGAT
ATAGAGACGGACGAAAGGGACAGACTTGAT|TGATTTTAGAGACGGACGAAAGGGACAGAC
GCTTAATTTAAGGTCCGCTTTCACATAAAA|ACGAAAGGGACAGACTTGATAGAGACGGAC
TGCGTACTATTAGGACAGACCCCAAGACAT|TTGACGAAGTAGGGGACACACACTCGTTCT
CGAAAGGGACAGACTTGATTATTCTTATAA|TGCGTACGCTCGGCCCTACCGAGGCGGAAC
TTAATAGCGAAGCTTATTTGAGATCAGTCG|TTTAGATGCCTTATTTGCGAGGTGAGGTGC
ACTTCTCGACCTAGCCCCGCACACGGATGC|ATTCTTGATTATCTAGTTGCGTACTATTTG
TCACTCAATCAAGGTCTGATACTCACAATC|CGAAAGGGACAGACTTGATTGGTTACAACG
TGGCACAAGCTAGCTCGGTTCCTCCCTGCA|GATTGTGTAGATCTTGGTAGATCGCAACGA
ACCGAAATCAAGTTCCACCAGCTGGAGACA|GAATCTGGAAACATTTCACCTGTGGGGTGA
AGGGACAGACTTGATTGGTTACAACGTACT|GGTTGGCACAAGCTAGCTCGGTTCCTCCCT
GAGACGGACGAAAGGGACAGACTTGATTTT|TCCAAATAGAGACGGACGAAAGGGACAGAC
AGACGGACGAAAGGGACAGACTTGATTGAC|GTTACTAACTGTAACTTCTCGACCTAGCCC
TTTCATCACGAGCCCGCCATCAAGCTAGTC|CGCGGACTAGGCTCGTAGGCATGAGTTCAG
ACAGACTTGATTCTTGATTATCTAGTTGCG|GGCATTTAATAGCGAAGCTTATTTGAGATC
GTGGCATTTAATAGCGAAGCTTATTTGAGA|ACTTGATTTTAGATGCCTTATTTGCGAGGT
CGATCCGATCAATAGAGACGGACGAAAGGG|AGGGACAGACTTGATTTTAGAGACGGACGA
GATCTGGGTATCCCGTTTGTCCCAGCCCAC|ATTGAACAGTGTCTAGAGACGGACGAAAGG
GAAAGTCGGACTCTCGATCCGATCAATAGA|TAGAGACGGACGAAAGGGACAGACTTGATT
TCATCTGAGTTTATTAGAGACGGACGAAAG|CCCGCCATCAAGCTAGTCCAAATAGAGACG
TTCCACCAGCTGGAGACAGACACTGGAGCA|ATTTCACCTGTGGGGTGATTGCCCTTCGGC
GTAGGGCCCCTCACTCAATCAAGGTCTGAT|ACTTGATTGACGAAAGGGACAGACTTGATT
TTATAACTCTTCCCCGTTAGGAATCTGGAA|CGGAACCGATTAACTACGACCAGCTGTAAG
AGAGACGTAGAGACGGACGAAAGGGACAGA|AGACTTGATTCAGCCACGATATCTCTAGGC
AGAATCCCTGCGGCAACAGAAGCACTCGGC|TTAGGACAGACCCCAAGACATTCAAGTCTC
CAGAAAGTCGGACTCTCGATCCGATCAATA|ATTAGAGACGGACGAAAGGGACAGACTTGA
TAGGTTTTGTTACTAACTGTAACTTCTCGA|CGGACGAAAGGGACAGACTTGATTCTTGAT
CTTGATTTTAGATGCCTTATTTGCGAGGTG|CACCAGCTGGAGACAGACACTGGAGCATTT
CTTATAACAGACGCTTAATTTAAGGTCCGC|CAATAGAGACGGACGAAAGGGACAGACTTG
TCTCAATAACGTCTTATAACAGACGCTTAA|TCTCGATCCGATCAATAGAGACGGACGAAA
GACGAAAGGGACAGACTTGATTGTGTAGAT|AACAGAAGCACTCGGCCGATCTGGGTATCC
ATTACACTAGCACATGACGTGCACTCAAGT|AGGGACAGACTTGATTACGGACGAAAGGGA
CGGCCGCGGACTAGGCTCGTAGGCATGAGT|GGATTCGAAGCCCGGGTTAGTGCTGTCGAT
CTTGATTGTGTAGATCTTGGTAGATCGCAA|CCGATCTGGGTATCCCGTTTGTCCCAGCCC
AACTCTTCCCCGTTAGGAATCTGGAAACAT|ACCGATTAACTACGACCAGCTGTAAGTCTG
TTCTTATAACTCTTCCCCGTTAGGAATCTG|AGGCGGAACCGATTAACTACGACCAGCTGT
CTCGGTTCCTCCCTGCAGTGATGAGCACGC|TTGGTAGATCGCAACGACGAGACAGCGGAC
CAGACTTGATTATTCTTATAACTCTTCCCC|TCGGCCCTACCGAGGCGGAACCGATTAACT
TTGACGAAGTAGGGGACACACACTCGTTCT|CCAGGTTAATTGCCCAGAAAGTCGGACTCT
ACCTAGCCCCGCACACGGATGCGTACTATT|TTATCTAGTTGCGTACTATTTGACGAAGTA
CGAAAGGGACAGACTTGATTTTAGAGACGG|GAGACGGACGAAAGGGACAGACTTGATTAT
CTCGATTGAACAGTGTCTAGAGACGGACGA|CGTCTTATAACAGACGCTTAATTTAAGGTC
ACACTCGTTCTCAATAACGTCTTATAACAG|AGTCGGACTCTCGATCCGATCAATAGAGAC
GTCCGCTTTCACATAAAATTGGAGACTATG|GACTTGATAGAGACGGACGAAAGGGACAGA
GACTTGATTGTGTAGATCTTGGTAGATCGC|GGCCGATCTGGGTATCCCGTTTGTCCCAGC
AAGGGACAGACTTGATTGTGTAGATCTTGG|AAGCACTCGGCCGATCTGGGTATCCCGTTT
TGCGTACTATTTGACGAAGTAGGGGACACA|GATCAGTCGTCCAGGTTAATTGCCCAGAAA
TGATTGACAGTGTAATGGTGAGTATGGAGA|CCTAGCCCCGCACACGGATGCGTACTATTA
GACAGACCCCAAGACATTCAAGTCTCGATT|GGACACACACTCGTTCTCAATAACGTCTTA
TGCCGTTCATCTGAGTTTATTAGAGACGGA|CACGAGCCCGCCATCAAGCTAGTCCAAATA
TGTGGCATTTAATAGCGAAGCTTATTTGAG|GACTTGATTTTAGATGCCTTATTTGCGAGG
TATTCGTAAGCGTCTCCGTCTTAAACTAGA|CAGTGTAATGGTGAGTATGGAGAATCCCTG
GGGACAGACTTGATTATTCTTATAACTCTT|ACGCTCGGCCCTACCGAGGCGGAACCGATT
AGCGGACTGCTAGAGACGGACGAAAGGGAC|TGAGTTAGGTTTTGTTACTAACTGTAACTT
ATTGCCCTTCGGCCGCGGACTAGGCTCGTA|TATACCGCGGGATTCGAAGCCCGGGTTAGT
GAGTTTATTAGAGACGGACGAAAGGGACAG|ATCAAGCTAGTCCAAATAGAGACGGACGAA
TTATCTAGTTGCGTACTATTTGACGAAGTA|CTTATTTGAGATCAGTCGTCCAGGTTAATT
ATAACAGACGCTTAATTTAAGGTCCGCTTT|TAGAGACGGACGAAAGGGACAGACTTGATA
ATTTGCGAGGTGAGGTGCCGTTCATCTGAG|ACTGGAGCATTTCATCACGAGCCCGCCATC
ACTATTTGACGAAGTAGGGGACACACACTC|GTCGTCCAGGTTAATTGCCCAGAAAGTCGG
CCTAGCCCCGCACACGGATGCGTACTATTA|TATCTAGTTGCGTACTATTTGACGAAGTAG
TAGGCTCGTAGGCATGAGTTCAGTCGTATG|CCGGGTTAGTGCTGTCGATCGCGGATGGGA
CGTTTGTCCCAGCCCACCACAGGGTGAGTT|TAGAGACGGACGAAAGGGACAGATAGAGAC
GTCCAGGTTAATTGCCCAGAAAGTCGGACT|CCGTTCATCTGAGTTTATTAGAGACGGACG
GAGATCAGTCGTCCAGGTTAATTGCCCAGA|AGGTGAGGTGCCGTTCATCTGAGTTTATTA
GGCAGCAAACATGAGGGGTTGGCACAAGCT|GGACGAAAGGGACAGACTTGATTGTGTAGA
GTGAGTTAGGTTTTGTTACTAACTGTAACT|TAGAGACGGACGAAAGGGACAGACTTGATT
GTTCCTCCCTGCAGTGATGAGCACGCCTAG|TAGATCGCAACGACGAGACAGCGGACTGCT
CTAGGCTCGTAGGCATGAGTTCAGTCGTAT|CCCGGGTTAGTGCTGTCGATCGCGGATGGG
CGTACTATTTGACGAAGTAGGGGACACACA|TCAGTCGTCCAGGTTAATTGCCCAGAAAGT
GACGAAAGGGACAGACTTGATTAACTTATT|CGGACGAAAGGGACAGACTTGATTGACAGT
CGATTGAACAGTGTCTAGAGACGGACGAAA|TCTTATAACAGACGCTTAATTTAAGGTCCG
ATTGGAGACTATGTGGCATTTAATAGCGAA|CGAAAGGGACAGACTTGATTTTAGATGCCT
