TTCTGGTTTTACCTCTGTGC -> TCTGGTTTTACCTCTGTGCA
GATCAATGAATGCTGTCGTG -> ATCAATGAATGCTGTCGTGT
CGTGTCTTCACGGTAAGAAC -> GTGTCTTCACGGTAAGAACG
CTGATTCGCTAGGGGGCCTA -> TGATTCGCTAGGGGGCCTAA
TCACGGTAAGAACGCCTTTA -> CACGGTAAGAACGCCTTTAC
TGTCTCCATGTGTCATGAAT -> GTCTCCATGTGTCATGAATC
CACTACGATTTTATAAGACG -> ACTACGATTTTATAAGACGC
AATCTCGCAAGTATCACCGG -> ATCTCGCAAGTATCACCGGG
ACCAGGTACTCGTGCGCTCT -> CCAGGTACTCGTGCGCTCTT
GTGAAGGTGGAAACTGTAGC -> TGAAGGTGGAAACTGTAGCT
TGCGACTGAATAATCCAGCA -> GCGACTGAATAATCCAGCAC
CTCTTACAGATGAACCGGGA -> TCTTACAGATGAACCGGGAG
CATGCGTCACGTCCGGGCGT -> ATGCGTCACGTCCGGGCGTA
GTCTCAACGGATGCCTGCAA -> TCTCAACGGATGCCTGCAAT
GCCTAGGCTCAGACTCGAGC -> CCTAGGCTCAGACTCGAGCC
GACTAAGGTTGTGTTGAGGC -> ACTAAGGTTGTGTTGAGGCT
ATGCACATCGACGCAATCAT -> TGCACATCGACGCAATCATT
GATGAACCGGGAGAGCCCCT -> ATGAACCGGGAGAGCCCCTC
CCACGTGTCTTCACGGTAAG -> CACGTGTCTTCACGGTAAGA
TGCTGTGGCACTGAGGTGAC -> GCTGTGGCACTGAGGTGACA
CAATTTCTTGCCTGCTGTGG -> AATTTCTTGCCTGCTGTGGC
ACCGCGCCGCCATAGGTGAA -> CCGCGCCGCCATAGGTGAAG
GCGCCGCCATAGGTGAAGGT -> CGCCGCCATAGGTGAAGGTG
ACTAATGCACATCGACGCAA -> CTAATGCACATCGACGCAAT
GATTCTGGTTTTACCTCTGT -> ATTCTGGTTTTACCTCTGTG
ATGGGAACTCCAGGGCATTA -> TGGGAACTCCAGGGCATTAG
AACCTGAAGGCAAGGCACTT -> ACCTGAAGGCAAGGCACTTA
CCGCGCCGCCATAGGTGAAG -> CGCGCCGCCATAGGTGAAGG
ACGGATGCCTGCAATTCCTG -> CGGATGCCTGCAATTCCTGA
GGTACATTGTGCAAATCACT -> GTACATTGTGCAAATCACTG
TTCGCCTAGGCTCAGACTCG -> TCGCCTAGGCTCAGACTCGA
GAACCGGGAGAGCCCCTCAG -> AACCGGGAGAGCCCCTCAGA
AGTTTGGAGACGCCGCTGCT -> GTTTGGAGACGCCGCTGCTG
GCCCGCGCACCGAGGGAGAA -> CCCGCGCACCGAGGGAGAAC
CTGTAGCTCGAGTGACAATG -> TGTAGCTCGAGTGACAATGG
CGCTAGGGGGCCTAATAACC -> GCTAGGGGGCCTAATAACCT
CCAGCACTGGTACATGCGTC -> CAGCACTGGTACATGCGTCA
CTAATAACCTTGTTGCTCAC -> TAATAACCTTGTTGCTCACC
CTCGTACATTTACTTTCTGG -> TCGTACATTTACTTTCTGGC
GCACCAGTTATTATGTTATT -> CACCAGTTATTATGTTATTT
GGTACATGCGTCACGTCCGG -> GTACATGCGTCACGTCCGGG
ACGGTAAGAACGCCTTTACT -> CGGTAAGAACGCCTTTACTT
ACAACAACGAATGTCCAAAA -> CAACAACGAATGTCCAAAAG
AGTGATCGCTCAATTTCTTG -> GTGATCGCTCAATTTCTTGC
GCTTCTGAAGACCCGCACAG -> CTTCTGAAGACCCGCACAGC
CGCTTCCTCACTCTCCGCGT -> GCTTCCTCACTCTCCGCGTC
CATCGACGCAATCATTAGAC -> ATCGACGCAATCATTAGACT
GCAAGGCACTTAACCGCGCC -> CAAGGCACTTAACCGCGCCG
TGAGTTTCTTCCACAACAAC -> GAGTTTCTTCCACAACAACG
ATCCAGCACTGGTACATGCG -> TCCAGCACTGGTACATGCGT
TCTACACGCTAACTTCGTTT -> CTACACGCTAACTTCGTTTG
TTTCTGGCCACGTGTCTTCA -> TTCTGGCCACGTGTCTTCAC
CCGCCATAGGTGAAGGTGGA -> CGCCATAGGTGAAGGTGGAA
CAGATGAACCGGGAGAGCCC -> AGATGAACCGGGAGAGCCCC
CCTTTACTTGGACTAACATT -> CTTTACTTGGACTAACATTA
GCGTACGAAGCCCGCGCACC -> CGTACGAAGCCCGCGCACCG
CAAGCTCTTGTCTCCATGTG -> AAGCTCTTGTCTCCATGTGT
GGTGACACGGAGGACCATTA -> GTGACACGGAGGACCATTAA
AAGGAATTCTGATTCGCTAG -> AGGAATTCTGATTCGCTAGG
GCGTCATGCAACTCTTGAGT -> CGTCATGCAACTCTTGAGTG
TGCCCAGGATAGTGAGTTTC -> GCCCAGGATAGTGAGTTTCT
AGGTTGTGTTGAGGCTCTCC -> GGTTGTGTTGAGGCTCTCCA
CTGCTTCTGAAGACCCGCAC -> TGCTTCTGAAGACCCGCACA
TTGATCAGAACTCAGTCTAC -> TGATCAGAACTCAGTCTACA
CGCGGGCGTCTCTAATGCCC -> GCGGGCGTCTCTAATGCCCA
TCTGACTAATGCACATCGAC -> CTGACTAATGCACATCGACG
CGCACCGAGGGAGAACGGCA -> GCACCGAGGGAGAACGGCAG
ACGATTTTATAAGACGCGTG -> CGATTTTATAAGACGCGTGC
TAGGCTCAGACTCGAGCCGT -> AGGCTCAGACTCGAGCCGTA
AACTCTTGAGTGATCGCTCA -> ACTCTTGAGTGATCGCTCAA
ATCAATGAATGCTGTCGTGT -> TCAATGAATGCTGTCGTGTA
GTGACAATGGGAACTCCAGG -> TGACAATGGGAACTCCAGGG
GTGTTGAGGCTCTCCAGGGT -> TGTTGAGGCTCTCCAGGGTT
GCTCTCCAGGGTTCGCCTAG -> CTCTCCAGGGTTCGCCTAGG
CGACGCAATCATTAGACTAA -> GACGCAATCATTAGACTAAG
ATTAGACTAAGGTTGTGTTG -> TTAGACTAAGGTTGTGTTGA
GAGTGATCGCTCAATTTCTT -> AGTGATCGCTCAATTTCTTG
ACAACGAATGTCCAAAAGGA -> CAACGAATGTCCAAAAGGAA
CGTACATTTACTTTCTGGCC -> GTACATTTACTTTCTGGCCA
TTACCTCTGTGCAACGATTC -> TACCTCTGTGCAACGATTCG
CAGGTACTCGTGCGCTCTTA -> AGGTACTCGTGCGCTCTTAC
GACTAACATTACAACACTAC -> ACTAACATTACAACACTACG
GCTCGAGTGACAATGGGAAC -> CTCGAGTGACAATGGGAACT
GAAGGCAAGGCACTTAACCG -> AAGGCAAGGCACTTAACCGC
TCTTACAGATGAACCGGGAG -> CTTACAGATGAACCGGGAGA
ACGAAGCCCGCGCACCGAGG -> CGAAGCCCGCGCACCGAGGG
GAATGCTGTCGTGTACACAC -> AATGCTGTCGTGTACACACG
GTGAGTTTCTTCCACAACAA -> TGAGTTTCTTCCACAACAAC
TTCGCTTCCTCACTCTCCGC -> TCGCTTCCTCACTCTCCGCG
AACTTCGTTTGTGATCAATG -> ACTTCGTTTGTGATCAATGA
CCTTGATCAGAACTCAGTCT -> CTTGATCAGAACTCAGTCTA
GGGTTCGCCTAGGCTCAGAC -> GGTTCGCCTAGGCTCAGACT
TGGTTTTACCTCTGTGCAAC -> GGTTTTACCTCTGTGCAACG
CTCGTGCGCTCTTACAGATG -> TCGTGCGCTCTTACAGATGA
GTTTGTGATCAATGAATGCT -> TTTGTGATCAATGAATGCTG
ACTTAACCGCGCCGCCATAG -> CTTAACCGCGCCGCCATAGG
ATGTCCAAAAGGAATTCTGA -> TGTCCAAAAGGAATTCTGAT
CTTGAGTGATCGCTCAATTT -> TTGAGTGATCGCTCAATTTC
TGAACCGGGAGAGCCCCTCA -> GAACCGGGAGAGCCCCTCAG
TTACTTTCTGGCCACGTGTC -> TACTTTCTGGCCACGTGTCT
TTCTACGAGAACACTTGTTA -> TCTACGAGAACACTTGTTAG
GAGCCCCTCAGAACCTGAAG -> AGCCCCTCAGAACCTGAAGG
TCGCAAGTATCACCGGGAAC -> CGCAAGTATCACCGGGAACT
GATAGTGAGTTTCTTCCACA -> ATAGTGAGTTTCTTCCACAA
TTTACTTGGACTAACATTAC -> TTACTTGGACTAACATTACA
TGTCATGAATCTGACTAATG -> GTCATGAATCTGACTAATGC
CCGCACAGCCTATCGCGAAG -> CGCACAGCCTATCGCGAAGA
GGTGAAGGTGGAAACTGTAG -> GTGAAGGTGGAAACTGTAGC
CGTCACGTCCGGGCGTACGA -> GTCACGTCCGGGCGTACGAA
TTCTGAAGACCCGCACAGCC -> TCTGAAGACCCGCACAGCCT
CCTGCTGTGGCACTGAGGTG -> CTGCTGTGGCACTGAGGTGA
TGATCAGAACTCAGTCTACA -> GATCAGAACTCAGTCTACAC
GCCACGTGTCTTCACGGTAA -> CCACGTGTCTTCACGGTAAG
ACATTACAACACTACGATTT -> CATTACAACACTACGATTTT
GAGAACACTTGTTAGTTACT -> AGAACACTTGTTAGTTACTA
TCAGAACTCAGTCTACACGC -> CAGAACTCAGTCTACACGCT
CAAGGCACTTAACCGCGCCG -> AAGGCACTTAACCGCGCCGC
ACCTCGTACATTTACTTTCT -> CCTCGTACATTTACTTTCTG
CCATGTGTCATGAATCTGAC -> CATGTGTCATGAATCTGACT
GTCGTGTACACACGTCGCGG -> TCGTGTACACACGTCGCGGG
AGAACCTGAAGGCAAGGCAC -> GAACCTGAAGGCAAGGCACT
TGTCACCGTAGTAATCTCGC -> GTCACCGTAGTAATCTCGCA
TCCAGCACTGGTACATGCGT -> CCAGCACTGGTACATGCGTC
TGTTGCTCACCACCAGGTAC -> GTTGCTCACCACCAGGTACT
ATTGTGCAAATCACTGCTTC -> TTGTGCAAATCACTGCTTCT
CTCTTGAGTGATCGCTCAAT -> TCTTGAGTGATCGCTCAATT
TCAATGAATGCTGTCGTGTA -> CAATGAATGCTGTCGTGTAC
CAACGGATGCCTGCAATTCC -> AACGGATGCCTGCAATTCCT
TTATAAGACGCGTGCACCAG -> TATAAGACGCGTGCACCAGT
ACCGAGGGAGAACGGCAGCT -> CCGAGGGAGAACGGCAGCTC
AGGATGGTACTAGTGCCGCG -> GGATGGTACTAGTGCCGCGC
TCTAATGCCCAGGATAGTGA -> CTAATGCCCAGGATAGTGAG
TTGTGATCAATGAATGCTGT -> TGTGATCAATGAATGCTGTC
TAGAAGGATGGTACTAGTGC -> AGAAGGATGGTACTAGTGCC
TCGTGCGCTCTTACAGATGA -> CGTGCGCTCTTACAGATGAA
TAAGGTTGTGTTGAGGCTCT -> AAGGTTGTGTTGAGGCTCTC
AGCTCGAGTGACAATGGGAA -> GCTCGAGTGACAATGGGAAC
GGAACTCCAGGGCATTAGAA -> GAACTCCAGGGCATTAGAAG
TGCTGTTCTACGAGAACACT -> GCTGTTCTACGAGAACACTT
ATGTTATTTTCACCGCACCA -> TGTTATTTTCACCGCACCAT
GTTATTATGTTATTTTCACC -> TTATTATGTTATTTTCACCG
GAAACTGTAGCTCGAGTGAC -> AAACTGTAGCTCGAGTGACA
CCTGTCTCAACGGATGCCTG -> CTGTCTCAACGGATGCCTGC
TCGCGAAGATAAGTGGAGAC -> CGCGAAGATAAGTGGAGACA
GGGCGTACGAAGCCCGCGCA -> GGCGTACGAAGCCCGCGCAC
GTTGTGTTGAGGCTCTCCAG -> TTGTGTTGAGGCTCTCCAGG
CAGCCCCACACTGCGACTGA -> AGCCCCACACTGCGACTGAA
CTGCAATTCCTGAACAGCCC -> TGCAATTCCTGAACAGCCCC
GATCAGAACTCAGTCTACAC -> ATCAGAACTCAGTCTACACG
TTAAAGGGCCTTGATCAGAA -> TAAAGGGCCTTGATCAGAAC
GATTTTATAAGACGCGTGCA -> ATTTTATAAGACGCGTGCAC
TCTGGCCACGTGTCTTCACG -> CTGGCCACGTGTCTTCACGG
GGCGTCTCTAATGCCCAGGA -> GCGTCTCTAATGCCCAGGAT
TGCAACGATTCGCTTCCTCA -> GCAACGATTCGCTTCCTCAC
AGACAAGCTCTTGTCTCCAT -> GACAAGCTCTTGTCTCCATG
CCTTGTTGCTCACCACCAGG -> CTTGTTGCTCACCACCAGGT
AGTACCCCTGTCTCAACGGA -> GTACCCCTGTCTCAACGGAT
GAATGTCCAAAAGGAATTCT -> AATGTCCAAAAGGAATTCTG
ACGTCCGGGCGTACGAAGCC -> CGTCCGGGCGTACGAAGCCC
CCCCTGTCTCAACGGATGCC -> CCCTGTCTCAACGGATGCCT
TGGAGACGCCGCTGCTGTTC -> GGAGACGCCGCTGCTGTTCT
AGGGTTCGCCTAGGCTCAGA -> GGGTTCGCCTAGGCTCAGAC
TCGTACATTTACTTTCTGGC -> CGTACATTTACTTTCTGGCC
CAACTCTTGAGTGATCGCTC -> AACTCTTGAGTGATCGCTCA
TGCACATCGACGCAATCATT -> GCACATCGACGCAATCATTA
GAAGATAAGTGGAGACAAGC -> AAGATAAGTGGAGACAAGCT
GCGCTCTTACAGATGAACCG -> CGCTCTTACAGATGAACCGG
CCATAGGTGAAGGTGGAAAC -> CATAGGTGAAGGTGGAAACT
TCAGAACCTGAAGGCAAGGC -> CAGAACCTGAAGGCAAGGCA
ATTAAAGGGCCTTGATCAGA -> TTAAAGGGCCTTGATCAGAA
CACCACCAGGTACTCGTGCG -> ACCACCAGGTACTCGTGCGC
GCTCAGGGTACATTGTGCAA -> CTCAGGGTACATTGTGCAAA
CCTTGTCACCGTAGTAATCT -> CTTGTCACCGTAGTAATCTC
TGCAACTCTTGAGTGATCGC -> GCAACTCTTGAGTGATCGCT
CCATGACACGAAGTACCCCT -> CATGACACGAAGTACCCCTG
TTGCCTGCTGTGGCACTGAG -> TGCCTGCTGTGGCACTGAGG
TGAACAGCCCCACACTGCGA -> GAACAGCCCCACACTGCGAC
CGGATGCCTGCAATTCCTGA -> GGATGCCTGCAATTCCTGAA
TGTAGCTCGAGTGACAATGG -> GTAGCTCGAGTGACAATGGG
GCATTAGAAGGATGGTACTA -> CATTAGAAGGATGGTACTAG
CTCTCCAGGGTTCGCCTAGG -> TCTCCAGGGTTCGCCTAGGC
ACAACACTACGATTTTATAA -> CAACACTACGATTTTATAAG
GCACAGCCTATCGCGAAGAT -> CACAGCCTATCGCGAAGATA
TAAGACGCGTGCACCAGTTA -> AAGACGCGTGCACCAGTTAT
TTTCTTGCCTGCTGTGGCAC -> TTCTTGCCTGCTGTGGCACT
AGACCCGCACAGCCTATCGC -> GACCCGCACAGCCTATCGCG
TAAGAACGCCTTTACTTGGA -> AAGAACGCCTTTACTTGGAC
TAAAGGGCCTTGATCAGAAC -> AAAGGGCCTTGATCAGAACT
CGCCATAGGTGAAGGTGGAA -> GCCATAGGTGAAGGTGGAAA
CCTGAAGGCAAGGCACTTAA -> CTGAAGGCAAGGCACTTAAC
GGAGACGCCGCTGCTGTTCT -> GAGACGCCGCTGCTGTTCTA
TAATGCCCAGGATAGTGAGT -> AATGCCCAGGATAGTGAGTT
AGGGAGAACGGCAGCTCAGG -> GGGAGAACGGCAGCTCAGGG
AGACTAAGGTTGTGTTGAGG -> GACTAAGGTTGTGTTGAGGC
ACCAGTTATTATGTTATTTT -> CCAGTTATTATGTTATTTTC
GAGAGCCCCTCAGAACCTGA -> AGAGCCCCTCAGAACCTGAA
GCTCACCTGATTCTGGTTTT -> CTCACCTGATTCTGGTTTTA
CGCGCACCGAGGGAGAACGG -> GCGCACCGAGGGAGAACGGC
AAGTGGAGACAAGCTCTTGT -> AGTGGAGACAAGCTCTTGTC
ATGAATCTGACTAATGCACA -> TGAATCTGACTAATGCACAT
CTCAGACTCGAGCCGTAAGT -> TCAGACTCGAGCCGTAAGTT
CCCACACTGCGACTGAATAA -> CCACACTGCGACTGAATAAT
TTTATAAGACGCGTGCACCA -> TTATAAGACGCGTGCACCAG
TCGCTAGGGGGCCTAATAAC -> CGCTAGGGGGCCTAATAACC
GTACACACGTCGCGGGCGTC -> TACACACGTCGCGGGCGTCT
GTAAGAACGCCTTTACTTGG -> TAAGAACGCCTTTACTTGGA
TAATCCAGCACTGGTACATG -> AATCCAGCACTGGTACATGC
TTTTACCTCTGTGCAACGAT -> TTTACCTCTGTGCAACGATT
TACACACGTCGCGGGCGTCT -> ACACACGTCGCGGGCGTCTC
TTTGTGATCAATGAATGCTG -> TTGTGATCAATGAATGCTGT
CGGGCGTCTCTAATGCCCAG -> GGGCGTCTCTAATGCCCAGG
AGGTACTCGTGCGCTCTTAC -> GGTACTCGTGCGCTCTTACA
AAGGCAAGGCACTTAACCGC -> AGGCAAGGCACTTAACCGCG
GAACGGCAGCTCAGGGTACA -> AACGGCAGCTCAGGGTACAT
CACCTGATTCTGGTTTTACC -> ACCTGATTCTGGTTTTACCT
CTTCTGAAGACCCGCACAGC -> TTCTGAAGACCCGCACAGCC
GTGGCACTGAGGTGACACGG -> TGGCACTGAGGTGACACGGA
GGGGCCTAATAACCTTGTTG -> GGGCCTAATAACCTTGTTGC
TACGAAGCCCGCGCACCGAG -> ACGAAGCCCGCGCACCGAGG
TTCCACAACAACGAATGTCC -> TCCACAACAACGAATGTCCA
TAATAACCTTGTTGCTCACC -> AATAACCTTGTTGCTCACCA
TTCGTTTGTGATCAATGAAT -> TCGTTTGTGATCAATGAATG
CGAATGTCCAAAAGGAATTC -> GAATGTCCAAAAGGAATTCT
TTCACCGCACCATGACACGA -> TCACCGCACCATGACACGAA
CTTGCCTGCTGTGGCACTGA -> TTGCCTGCTGTGGCACTGAG
AGCCTATCGCGAAGATAAGT -> GCCTATCGCGAAGATAAGTG
CCGCGCACCGAGGGAGAACG -> CGCGCACCGAGGGAGAACGG
AGGTGACACGGAGGACCATT -> GGTGACACGGAGGACCATTA
CAGGGCATTAGAAGGATGGT -> AGGGCATTAGAAGGATGGTA
CACACCTCGTACATTTACTT -> ACACCTCGTACATTTACTTT
GTTTTACCTCTGTGCAACGA -> TTTTACCTCTGTGCAACGAT
CTGCGACTGAATAATCCAGC -> TGCGACTGAATAATCCAGCA
GACGCCGCTGCTGTTCTACG -> ACGCCGCTGCTGTTCTACGA
AGAACACTTGTTAGTTACTA -> GAACACTTGTTAGTTACTAC
CGGGCGTACGAAGCCCGCGC -> GGGCGTACGAAGCCCGCGCA
GCCTATCGCGAAGATAAGTG -> CCTATCGCGAAGATAAGTGG
AGTGACAATGGGAACTCCAG -> GTGACAATGGGAACTCCAGG
TTCGCTAGGGGGCCTAATAA -> TCGCTAGGGGGCCTAATAAC
GATGGTACTAGTGCCGCGCG -> ATGGTACTAGTGCCGCGCGC
GAAGTACCCCTGTCTCAACG -> AAGTACCCCTGTCTCAACGG
CACCTCGTACATTTACTTTC -> ACCTCGTACATTTACTTTCT
GAGGGAGAACGGCAGCTCAG -> AGGGAGAACGGCAGCTCAGG
CTCACCTGATTCTGGTTTTA -> TCACCTGATTCTGGTTTTAC
ACGCTAACTTCGTTTGTGAT -> CGCTAACTTCGTTTGTGATC
CCAGTTATTATGTTATTTTC -> CAGTTATTATGTTATTTTCA
CATGTGTCATGAATCTGACT -> ATGTGTCATGAATCTGACTA
CCAGGATAGTGAGTTTCTTC -> CAGGATAGTGAGTTTCTTCC
TCTGATTCGCTAGGGGGCCT -> CTGATTCGCTAGGGGGCCTA
CTCCGCTCACCTGATTCTGG -> TCCGCTCACCTGATTCTGGT
TCGCTCAATTTCTTGCCTGC -> CGCTCAATTTCTTGCCTGCT
GAGTGACAATGGGAACTCCA -> AGTGACAATGGGAACTCCAG
CTTGATCAGAACTCAGTCTA -> TTGATCAGAACTCAGTCTAC
TACAGATGAACCGGGAGAGC -> ACAGATGAACCGGGAGAGCC
TATAAGACGCGTGCACCAGT -> ATAAGACGCGTGCACCAGTT
TGTGGCACTGAGGTGACACG -> GTGGCACTGAGGTGACACGG
ACGAAGTACCCCTGTCTCAA -> CGAAGTACCCCTGTCTCAAC
GCCATAGGTGAAGGTGGAAA -> CCATAGGTGAAGGTGGAAAC
ACCGGGAGAGCCCCTCAGAA -> CCGGGAGAGCCCCTCAGAAC
ACCTGAAGGCAAGGCACTTA -> CCTGAAGGCAAGGCACTTAA
AACTGTAGCTCGAGTGACAA -> ACTGTAGCTCGAGTGACAAT
TCAGGGTACATTGTGCAAAT -> CAGGGTACATTGTGCAAATC
AGACGCCGCTGCTGTTCTAC -> GACGCCGCTGCTGTTCTACG
GTGGAAACTGTAGCTCGAGT -> TGGAAACTGTAGCTCGAGTG
GGTAAGAACGCCTTTACTTG -> GTAAGAACGCCTTTACTTGG
TCCGCGTCATGCAACTCTTG -> CCGCGTCATGCAACTCTTGA
ACTTGTTAGTTACTACCTTG -> CTTGTTAGTTACTACCTTGT
TTCCTCACTCTCCGCGTCAT -> TCCTCACTCTCCGCGTCATG
TCCGCTCACCTGATTCTGGT -> CCGCTCACCTGATTCTGGTT
AGTGGAGACAAGCTCTTGTC -> GTGGAGACAAGCTCTTGTCT
TTCTGATTCGCTAGGGGGCC -> TCTGATTCGCTAGGGGGCCT
CTGTTCTACGAGAACACTTG -> TGTTCTACGAGAACACTTGT
AACGAATGTCCAAAAGGAAT -> ACGAATGTCCAAAAGGAATT
CCTAATAACCTTGTTGCTCA -> CTAATAACCTTGTTGCTCAC
AGGTGGAAACTGTAGCTCGA -> GGTGGAAACTGTAGCTCGAG
CACCATGACACGAAGTACCC -> ACCATGACACGAAGTACCCC
ATTCCTGAACAGCCCCACAC -> TTCCTGAACAGCCCCACACT
GAGAACGGCAGCTCAGGGTA -> AGAACGGCAGCTCAGGGTAC
CCAGGGTTCGCCTAGGCTCA -> CAGGGTTCGCCTAGGCTCAG
TCACCTGATTCTGGTTTTAC -> CACCTGATTCTGGTTTTACC
GAACGCCTTTACTTGGACTA -> AACGCCTTTACTTGGACTAA
TTGGACTAACATTACAACAC -> TGGACTAACATTACAACACT
CATGAATCTGACTAATGCAC -> ATGAATCTGACTAATGCACA
TTGTTGCTCACCACCAGGTA -> TGTTGCTCACCACCAGGTAC
AAACTGTAGCTCGAGTGACA -> AACTGTAGCTCGAGTGACAA
CGCTCACCTGATTCTGGTTT -> GCTCACCTGATTCTGGTTTT
CTGAAGGCAAGGCACTTAAC -> TGAAGGCAAGGCACTTAACC
ATTCGCTAGGGGGCCTAATA -> TTCGCTAGGGGGCCTAATAA
ACACGTCGCGGGCGTCTCTA -> CACGTCGCGGGCGTCTCTAA
GTCCAAAAGGAATTCTGATT -> TCCAAAAGGAATTCTGATTC
CGGTAAGAACGCCTTTACTT -> GGTAAGAACGCCTTTACTTG
CCTCAGAACCTGAAGGCAAG -> CTCAGAACCTGAAGGCAAGG
CAACGAATGTCCAAAAGGAA -> AACGAATGTCCAAAAGGAAT
CCCTCAGAACCTGAAGGCAA -> CCTCAGAACCTGAAGGCAAG
AAAGGGCCTTGATCAGAACT -> AAGGGCCTTGATCAGAACTC
AACACTACGATTTTATAAGA -> ACACTACGATTTTATAAGAC
CACCGCACCATGACACGAAG -> ACCGCACCATGACACGAAGT
ATTACAACACTACGATTTTA -> TTACAACACTACGATTTTAT
CTCAATTTCTTGCCTGCTGT -> TCAATTTCTTGCCTGCTGTG
ATGCTGTCGTGTACACACGT -> TGCTGTCGTGTACACACGTC
TTAGTTACTACCTTGTCACC -> TAGTTACTACCTTGTCACCG
CTGAATAATCCAGCACTGGT -> TGAATAATCCAGCACTGGTA
GTAGTAATCTCGCAAGTATC -> TAGTAATCTCGCAAGTATCA
AAAAGGAATTCTGATTCGCT -> AAAGGAATTCTGATTCGCTA
TCGAGTGACAATGGGAACTC -> CGAGTGACAATGGGAACTCC
GTCTCTAATGCCCAGGATAG -> TCTCTAATGCCCAGGATAGT
TCAGACTCGAGCCGTAAGTT -> CAGACTCGAGCCGTAAGTTT
GCCGCGCGCACACCTCGTAC -> CCGCGCGCACACCTCGTACA
AGATGAACCGGGAGAGCCCC -> GATGAACCGGGAGAGCCCCT
GCCTGCAATTCCTGAACAGC -> CCTGCAATTCCTGAACAGCC
AACCGGGAGAGCCCCTCAGA -> ACCGGGAGAGCCCCTCAGAA
GTTTCTTCCACAACAACGAA -> TTTCTTCCACAACAACGAAT
GGCCTAATAACCTTGTTGCT -> GCCTAATAACCTTGTTGCTC
GTTGCTCACCACCAGGTACT -> TTGCTCACCACCAGGTACTC
CTACGATTTTATAAGACGCG -> TACGATTTTATAAGACGCGT
CGTGCACCAGTTATTATGTT -> GTGCACCAGTTATTATGTTA
GCAACTCTTGAGTGATCGCT -> CAACTCTTGAGTGATCGCTC
ACTGCTTCTGAAGACCCGCA -> CTGCTTCTGAAGACCCGCAC
TGAAGACCCGCACAGCCTAT -> GAAGACCCGCACAGCCTATC
CAATGGGAACTCCAGGGCAT -> AATGGGAACTCCAGGGCATT
GCTGTCGTGTACACACGTCG -> CTGTCGTGTACACACGTCGC
CATAGGTGAAGGTGGAAACT -> ATAGGTGAAGGTGGAAACTG
GTGTCTTCACGGTAAGAACG -> TGTCTTCACGGTAAGAACGC
CTTGTCTCCATGTGTCATGA -> TTGTCTCCATGTGTCATGAA
CTGTGCAACGATTCGCTTCC -> TGTGCAACGATTCGCTTCCT
GGCCTTGATCAGAACTCAGT -> GCCTTGATCAGAACTCAGTC
CTTGTCACCGTAGTAATCTC -> TTGTCACCGTAGTAATCTCG
CTACGAGAACACTTGTTAGT -> TACGAGAACACTTGTTAGTT
GCGCGCACACCTCGTACATT -> CGCGCACACCTCGTACATTT
GCGTGCACCAGTTATTATGT -> CGTGCACCAGTTATTATGTT
TGTACACACGTCGCGGGCGT -> GTACACACGTCGCGGGCGTC
AATTCTGATTCGCTAGGGGG -> ATTCTGATTCGCTAGGGGGC
TCTTCCACAACAACGAATGT -> CTTCCACAACAACGAATGTC
TGTGCAAATCACTGCTTCTG -> GTGCAAATCACTGCTTCTGA
GTGCAACGATTCGCTTCCTC -> TGCAACGATTCGCTTCCTCA
CAAATCACTGCTTCTGAAGA -> AAATCACTGCTTCTGAAGAC
CGTAAGTTTGGAGACGCCGC -> GTAAGTTTGGAGACGCCGCT
GTTAGTTACTACCTTGTCAC -> TTAGTTACTACCTTGTCACC
AATGAATGCTGTCGTGTACA -> ATGAATGCTGTCGTGTACAC
GGCAGCTCAGGGTACATTGT -> GCAGCTCAGGGTACATTGTG
TGAAGGCAAGGCACTTAACC -> GAAGGCAAGGCACTTAACCG
CTGGTACATGCGTCACGTCC -> TGGTACATGCGTCACGTCCG
ACGAGAACACTTGTTAGTTA -> CGAGAACACTTGTTAGTTAC
TCTCTAATGCCCAGGATAGT -> CTCTAATGCCCAGGATAGTG
CCTGCAATTCCTGAACAGCC -> CTGCAATTCCTGAACAGCCC
GATGCCTGCAATTCCTGAAC -> ATGCCTGCAATTCCTGAACA
AAGAACGCCTTTACTTGGAC -> AGAACGCCTTTACTTGGACT
CTCACTCTCCGCGTCATGCA -> TCACTCTCCGCGTCATGCAA
GGGCCTAATAACCTTGTTGC -> GGCCTAATAACCTTGTTGCT
AATAACCTTGTTGCTCACCA -> ATAACCTTGTTGCTCACCAC
AAGACCCGCACAGCCTATCG -> AGACCCGCACAGCCTATCGC
CACTGCGACTGAATAATCCA -> ACTGCGACTGAATAATCCAG
AATGCCCAGGATAGTGAGTT -> ATGCCCAGGATAGTGAGTTT
GGGCGTCTCTAATGCCCAGG -> GGCGTCTCTAATGCCCAGGA
GACACGGAGGACCATTAAAG -> ACACGGAGGACCATTAAAGG
AATCACTGCTTCTGAAGACC -> ATCACTGCTTCTGAAGACCC
CGAGTGACAATGGGAACTCC -> GAGTGACAATGGGAACTCCA
AGAACGCCTTTACTTGGACT -> GAACGCCTTTACTTGGACTA
CCACCAGGTACTCGTGCGCT -> CACCAGGTACTCGTGCGCTC
TGTCGTGTACACACGTCGCG -> GTCGTGTACACACGTCGCGG
AAATCACTGCTTCTGAAGAC -> AATCACTGCTTCTGAAGACC
GGCGTACGAAGCCCGCGCAC -> GCGTACGAAGCCCGCGCACC
CTAACTTCGTTTGTGATCAA -> TAACTTCGTTTGTGATCAAT
ACATCGACGCAATCATTAGA -> CATCGACGCAATCATTAGAC
TACTAGTGCCGCGCGCACAC -> ACTAGTGCCGCGCGCACACC
TGGACTAACATTACAACACT -> GGACTAACATTACAACACTA
AGGCAAGGCACTTAACCGCG -> GGCAAGGCACTTAACCGCGC
ATTCTGATTCGCTAGGGGGC -> TTCTGATTCGCTAGGGGGCC
GCCCAGGATAGTGAGTTTCT -> CCCAGGATAGTGAGTTTCTT
ATCAGAACTCAGTCTACACG -> TCAGAACTCAGTCTACACGC
TGATTCTGGTTTTACCTCTG -> GATTCTGGTTTTACCTCTGT
GCGAAGATAAGTGGAGACAA -> CGAAGATAAGTGGAGACAAG
GTCGCGGGCGTCTCTAATGC -> TCGCGGGCGTCTCTAATGCC
TGTCCAAAAGGAATTCTGAT -> GTCCAAAAGGAATTCTGATT
CACCAGTTATTATGTTATTT -> ACCAGTTATTATGTTATTTT
TTTGGAGACGCCGCTGCTGT -> TTGGAGACGCCGCTGCTGTT
AGGCTCAGACTCGAGCCGTA -> GGCTCAGACTCGAGCCGTAA
TCACCGCACCATGACACGAA -> CACCGCACCATGACACGAAG
GGGTACATTGTGCAAATCAC -> GGTACATTGTGCAAATCACT
ACGCAATCATTAGACTAAGG -> CGCAATCATTAGACTAAGGT
TCTGTGCAACGATTCGCTTC -> CTGTGCAACGATTCGCTTCC
CTGAAGACCCGCACAGCCTA -> TGAAGACCCGCACAGCCTAT
GGGAGAGCCCCTCAGAACCT -> GGAGAGCCCCTCAGAACCTG
TCAGTCTACACGCTAACTTC -> CAGTCTACACGCTAACTTCG
TTTACCTCTGTGCAACGATT -> TTACCTCTGTGCAACGATTC
TGGAAACTGTAGCTCGAGTG -> GGAAACTGTAGCTCGAGTGA
ATCACTGCTTCTGAAGACCC -> TCACTGCTTCTGAAGACCCG
CACTTAACCGCGCCGCCATA -> ACTTAACCGCGCCGCCATAG
GCGGGCGTCTCTAATGCCCA -> CGGGCGTCTCTAATGCCCAG
CTGCTGTTCTACGAGAACAC -> TGCTGTTCTACGAGAACACT
CACATCGACGCAATCATTAG -> ACATCGACGCAATCATTAGA
TCACTGCTTCTGAAGACCCG -> CACTGCTTCTGAAGACCCGC
CATGACACGAAGTACCCCTG -> ATGACACGAAGTACCCCTGT
CTGGCCACGTGTCTTCACGG -> TGGCCACGTGTCTTCACGGT
CCCCACACTGCGACTGAATA -> CCCACACTGCGACTGAATAA
CGGGAGAGCCCCTCAGAACC -> GGGAGAGCCCCTCAGAACCT
ACTGAGGTGACACGGAGGAC -> CTGAGGTGACACGGAGGACC
AACTCCAGGGCATTAGAAGG -> ACTCCAGGGCATTAGAAGGA
CGCCGCTGCTGTTCTACGAG -> GCCGCTGCTGTTCTACGAGA
TGTGCAACGATTCGCTTCCT -> GTGCAACGATTCGCTTCCTC
GGAATTCTGATTCGCTAGGG -> GAATTCTGATTCGCTAGGGG
TTCACGGTAAGAACGCCTTT -> TCACGGTAAGAACGCCTTTA
GTCTACACGCTAACTTCGTT -> TCTACACGCTAACTTCGTTT
TGCCTGCAATTCCTGAACAG -> GCCTGCAATTCCTGAACAGC
TCTCAACGGATGCCTGCAAT -> CTCAACGGATGCCTGCAATT
GAACTCCAGGGCATTAGAAG -> AACTCCAGGGCATTAGAAGG
CGTTTGTGATCAATGAATGC -> GTTTGTGATCAATGAATGCT
ACTTCGTTTGTGATCAATGA -> CTTCGTTTGTGATCAATGAA
TAGTTACTACCTTGTCACCG -> AGTTACTACCTTGTCACCGT
GTCATGCAACTCTTGAGTGA -> TCATGCAACTCTTGAGTGAT
CACAACAACGAATGTCCAAA -> ACAACAACGAATGTCCAAAA
ACTCCAGGGCATTAGAAGGA -> CTCCAGGGCATTAGAAGGAT
ACGAATGTCCAAAAGGAATT -> CGAATGTCCAAAAGGAATTC
GGGAACTCCAGGGCATTAGA -> GGAACTCCAGGGCATTAGAA
GCAAATCACTGCTTCTGAAG -> CAAATCACTGCTTCTGAAGA
TCAATTTCTTGCCTGCTGTG -> CAATTTCTTGCCTGCTGTGG
GCGCACCGAGGGAGAACGGC -> CGCACCGAGGGAGAACGGCA
CAGAACTCAGTCTACACGCT -> AGAACTCAGTCTACACGCTA
ACCATTAAAGGGCCTTGATC -> CCATTAAAGGGCCTTGATCA
CGCGTCATGCAACTCTTGAG -> GCGTCATGCAACTCTTGAGT
ACGGCAGCTCAGGGTACATT -> CGGCAGCTCAGGGTACATTG
TTTCTCCGCTCACCTGATTC -> TTCTCCGCTCACCTGATTCT
TGTTGAGGCTCTCCAGGGTT -> GTTGAGGCTCTCCAGGGTTC
GGCATTAGAAGGATGGTACT -> GCATTAGAAGGATGGTACTA
ACTGAATAATCCAGCACTGG -> CTGAATAATCCAGCACTGGT
CCCCTCAGAACCTGAAGGCA -> CCCTCAGAACCTGAAGGCAA
CACTTGTTAGTTACTACCTT -> ACTTGTTAGTTACTACCTTG
TGAAGGTGGAAACTGTAGCT -> GAAGGTGGAAACTGTAGCTC
TTAACCGCGCCGCCATAGGT -> TAACCGCGCCGCCATAGGTG
TCCGGGCGTACGAAGCCCGC -> CCGGGCGTACGAAGCCCGCG
GGAGGACCATTAAAGGGCCT -> GAGGACCATTAAAGGGCCTT
TTGTGTTGAGGCTCTCCAGG -> TGTGTTGAGGCTCTCCAGGG
CGCACAGCCTATCGCGAAGA -> GCACAGCCTATCGCGAAGAT
TACTACCTTGTCACCGTAGT -> ACTACCTTGTCACCGTAGTA
TCGTTTGTGATCAATGAATG -> CGTTTGTGATCAATGAATGC
AAGCTCTTGTCTCCATGTGT -> AGCTCTTGTCTCCATGTGTC
CGCACACCTCGTACATTTAC -> GCACACCTCGTACATTTACT
ACTCTCCGCGTCATGCAACT -> CTCTCCGCGTCATGCAACTC
GGATGCCTGCAATTCCTGAA -> GATGCCTGCAATTCCTGAAC
GAGGCTCTCCAGGGTTCGCC -> AGGCTCTCCAGGGTTCGCCT
CGTCGCGGGCGTCTCTAATG -> GTCGCGGGCGTCTCTAATGC
AGCCCCACACTGCGACTGAA -> GCCCCACACTGCGACTGAAT
CTCCATGTGTCATGAATCTG -> TCCATGTGTCATGAATCTGA
CGTCTCTAATGCCCAGGATA -> GTCTCTAATGCCCAGGATAG
AAGTACCCCTGTCTCAACGG -> AGTACCCCTGTCTCAACGGA
ACGCGTGCACCAGTTATTAT -> CGCGTGCACCAGTTATTATG
CGCCGCCATAGGTGAAGGTG -> GCCGCCATAGGTGAAGGTGG
GAACTCAGTCTACACGCTAA -> AACTCAGTCTACACGCTAAC
GTAAGTTTGGAGACGCCGCT -> TAAGTTTGGAGACGCCGCTG
ACGCCTTTACTTGGACTAAC -> CGCCTTTACTTGGACTAACA
ATCTCGCAAGTATCACCGGG -> TCTCGCAAGTATCACCGGGA
TTACAGATGAACCGGGAGAG -> TACAGATGAACCGGGAGAGC
TAAGTGGAGACAAGCTCTTG -> AAGTGGAGACAAGCTCTTGT
GAATCTGACTAATGCACATC -> AATCTGACTAATGCACATCG
AATTTCTTGCCTGCTGTGGC -> ATTTCTTGCCTGCTGTGGCA
TGAGGCTCTCCAGGGTTCGC -> GAGGCTCTCCAGGGTTCGCC
TATCGCGAAGATAAGTGGAG -> ATCGCGAAGATAAGTGGAGA
TGATCAATGAATGCTGTCGT -> GATCAATGAATGCTGTCGTG
TGAATAATCCAGCACTGGTA -> GAATAATCCAGCACTGGTAC
TCCAGGGCATTAGAAGGATG -> CCAGGGCATTAGAAGGATGG
CTGACTAATGCACATCGACG -> TGACTAATGCACATCGACGC
TGACACGGAGGACCATTAAA -> GACACGGAGGACCATTAAAG
GTGCAAATCACTGCTTCTGA -> TGCAAATCACTGCTTCTGAA
ACTTTCTGGCCACGTGTCTT -> CTTTCTGGCCACGTGTCTTC
ACACTGCGACTGAATAATCC -> CACTGCGACTGAATAATCCA
ATCGCGAAGATAAGTGGAGA -> TCGCGAAGATAAGTGGAGAC
AAGTTTGGAGACGCCGCTGC -> AGTTTGGAGACGCCGCTGCT
GTGACACGGAGGACCATTAA -> TGACACGGAGGACCATTAAA
CGATTTTATAAGACGCGTGC -> GATTTTATAAGACGCGTGCA
AGTCTACACGCTAACTTCGT -> GTCTACACGCTAACTTCGTT
TATGTTATTTTCACCGCACC -> ATGTTATTTTCACCGCACCA
ACGGAGGACCATTAAAGGGC -> CGGAGGACCATTAAAGGGCC
GTACCCCTGTCTCAACGGAT -> TACCCCTGTCTCAACGGATG
GTTCTACGAGAACACTTGTT -> TTCTACGAGAACACTTGTTA
GACGCAATCATTAGACTAAG -> ACGCAATCATTAGACTAAGG
TCATTAGACTAAGGTTGTGT -> CATTAGACTAAGGTTGTGTT
GGTTGTGTTGAGGCTCTCCA -> GTTGTGTTGAGGCTCTCCAG
GACGCGTGCACCAGTTATTA -> ACGCGTGCACCAGTTATTAT
CCGGGAGAGCCCCTCAGAAC -> CGGGAGAGCCCCTCAGAACC
TACCTTGTCACCGTAGTAAT -> ACCTTGTCACCGTAGTAATC
TACTTTCTGGCCACGTGTCT -> ACTTTCTGGCCACGTGTCTT
ACATTGTGCAAATCACTGCT -> CATTGTGCAAATCACTGCTT
CCGCACCATGACACGAAGTA -> CGCACCATGACACGAAGTAC
CGTCATGCAACTCTTGAGTG -> GTCATGCAACTCTTGAGTGA
CCTCACTCTCCGCGTCATGC -> CTCACTCTCCGCGTCATGCA
TGCGTCACGTCCGGGCGTAC -> GCGTCACGTCCGGGCGTACG
CACGAAGTACCCCTGTCTCA -> ACGAAGTACCCCTGTCTCAA
CGCAATCATTAGACTAAGGT -> GCAATCATTAGACTAAGGTT
CTGGTTTTACCTCTGTGCAA -> TGGTTTTACCTCTGTGCAAC
AGGAATTCTGATTCGCTAGG -> GGAATTCTGATTCGCTAGGG
GCCGCCATAGGTGAAGGTGG -> CCGCCATAGGTGAAGGTGGA
TACACGCTAACTTCGTTTGT -> ACACGCTAACTTCGTTTGTG
AACATTACAACACTACGATT -> ACATTACAACACTACGATTT
AGCCCCTCAGAACCTGAAGG -> GCCCCTCAGAACCTGAAGGC
TCTCCATGTGTCATGAATCT -> CTCCATGTGTCATGAATCTG
GGACCATTAAAGGGCCTTGA -> GACCATTAAAGGGCCTTGAT
CCAGGGCATTAGAAGGATGG -> CAGGGCATTAGAAGGATGGT
CTGTCTCAACGGATGCCTGC -> TGTCTCAACGGATGCCTGCA
GTACATTTACTTTCTGGCCA -> TACATTTACTTTCTGGCCAC
TGCTCACCACCAGGTACTCG -> GCTCACCACCAGGTACTCGT
GCCTTGATCAGAACTCAGTC -> CCTTGATCAGAACTCAGTCT
CTCTAATGCCCAGGATAGTG -> TCTAATGCCCAGGATAGTGA
AGCTCAGGGTACATTGTGCA -> GCTCAGGGTACATTGTGCAA
AGCCCGCGCACCGAGGGAGA -> GCCCGCGCACCGAGGGAGAA
TAGCTCGAGTGACAATGGGA -> AGCTCGAGTGACAATGGGAA
ACAAGCTCTTGTCTCCATGT -> CAAGCTCTTGTCTCCATGTG
GCCCCTCAGAACCTGAAGGC -> CCCCTCAGAACCTGAAGGCA
GGAGAGCCCCTCAGAACCTG -> GAGAGCCCCTCAGAACCTGA
GCTGCTGTTCTACGAGAACA -> CTGCTGTTCTACGAGAACAC
ATTCGCTTCCTCACTCTCCG -> TTCGCTTCCTCACTCTCCGC
ACTCGAGCCGTAAGTTTGGA -> CTCGAGCCGTAAGTTTGGAG
CCCGCACAGCCTATCGCGAA -> CCGCACAGCCTATCGCGAAG
CAATTCCTGAACAGCCCCAC -> AATTCCTGAACAGCCCCACA
TGACAATGGGAACTCCAGGG -> GACAATGGGAACTCCAGGGC
CTCAGAACCTGAAGGCAAGG -> TCAGAACCTGAAGGCAAGGC
CATGCAACTCTTGAGTGATC -> ATGCAACTCTTGAGTGATCG
TGTCTTCACGGTAAGAACGC -> GTCTTCACGGTAAGAACGCC
GCACCATGACACGAAGTACC -> CACCATGACACGAAGTACCC
GCACACCTCGTACATTTACT -> CACACCTCGTACATTTACTT
TACAACACTACGATTTTATA -> ACAACACTACGATTTTATAA
CAGAACCTGAAGGCAAGGCA -> AGAACCTGAAGGCAAGGCAC
CGCTGCTGTTCTACGAGAAC -> GCTGCTGTTCTACGAGAACA
AGAAGGATGGTACTAGTGCC -> GAAGGATGGTACTAGTGCCG
CACGTCGCGGGCGTCTCTAA -> ACGTCGCGGGCGTCTCTAAT
TCAACGGATGCCTGCAATTC -> CAACGGATGCCTGCAATTCC
CTCAACGGATGCCTGCAATT -> TCAACGGATGCCTGCAATTC
CACACGTCGCGGGCGTCTCT -> ACACGTCGCGGGCGTCTCTA
TCATGAATCTGACTAATGCA -> CATGAATCTGACTAATGCAC
ACCGTAGTAATCTCGCAAGT -> CCGTAGTAATCTCGCAAGTA
GTAATCTCGCAAGTATCACC -> TAATCTCGCAAGTATCACCG
GACACGAAGTACCCCTGTCT -> ACACGAAGTACCCCTGTCTC
ACTTGGACTAACATTACAAC -> CTTGGACTAACATTACAACA
GGGCCTTGATCAGAACTCAG -> GGCCTTGATCAGAACTCAGT
GCACTGAGGTGACACGGAGG -> CACTGAGGTGACACGGAGGA
CGACTGAATAATCCAGCACT -> GACTGAATAATCCAGCACTG
ACACACGTCGCGGGCGTCTC -> CACACGTCGCGGGCGTCTCT
CTTGGACTAACATTACAACA -> TTGGACTAACATTACAACAC
TCTCGCAAGTATCACCGGGA -> CTCGCAAGTATCACCGGGAA
ACCATGACACGAAGTACCCC -> CCATGACACGAAGTACCCCT
CCTGATTCTGGTTTTACCTC -> CTGATTCTGGTTTTACCTCT
GCTTCCTCACTCTCCGCGTC -> CTTCCTCACTCTCCGCGTCA
CTAGTGCCGCGCGCACACCT -> TAGTGCCGCGCGCACACCTC
ACTACGATTTTATAAGACGC -> CTACGATTTTATAAGACGCG
GACTGAATAATCCAGCACTG -> ACTGAATAATCCAGCACTGG
TTTTCACCGCACCATGACAC -> TTTCACCGCACCATGACACG
GATTCGCTAGGGGGCCTAAT -> ATTCGCTAGGGGGCCTAATA
GCCTTTACTTGGACTAACAT -> CCTTTACTTGGACTAACATT
CTTACAGATGAACCGGGAGA -> TTACAGATGAACCGGGAGAG
AAGGCACTTAACCGCGCCGC -> AGGCACTTAACCGCGCCGCC
AGACTCGAGCCGTAAGTTTG -> GACTCGAGCCGTAAGTTTGG
CTCACCACCAGGTACTCGTG -> TCACCACCAGGTACTCGTGC
TAACCTTGTTGCTCACCACC -> AACCTTGTTGCTCACCACCA
TTAGACTAAGGTTGTGTTGA -> TAGACTAAGGTTGTGTTGAG
TACCCCTGTCTCAACGGATG -> ACCCCTGTCTCAACGGATGC
GACTCGAGCCGTAAGTTTGG -> ACTCGAGCCGTAAGTTTGGA
ACATTTACTTTCTGGCCACG -> CATTTACTTTCTGGCCACGT
GGCACTGAGGTGACACGGAG -> GCACTGAGGTGACACGGAGG
TTATGTTATTTTCACCGCAC -> TATGTTATTTTCACCGCACC
CAGCTCAGGGTACATTGTGC -> AGCTCAGGGTACATTGTGCA
TGACTAATGCACATCGACGC -> GACTAATGCACATCGACGCA
ACATGCGTCACGTCCGGGCG -> CATGCGTCACGTCCGGGCGT
GCACCGAGGGAGAACGGCAG -> CACCGAGGGAGAACGGCAGC
CTCTTGTCTCCATGTGTCAT -> TCTTGTCTCCATGTGTCATG
CGTACGAAGCCCGCGCACCG -> GTACGAAGCCCGCGCACCGA
CGCACCATGACACGAAGTAC -> GCACCATGACACGAAGTACC
ACCCCTGTCTCAACGGATGC -> CCCCTGTCTCAACGGATGCC
GATCGCTCAATTTCTTGCCT -> ATCGCTCAATTTCTTGCCTG
GAAGGTGGAAACTGTAGCTC -> AAGGTGGAAACTGTAGCTCG
GACAAGCTCTTGTCTCCATG -> ACAAGCTCTTGTCTCCATGT
TACATGCGTCACGTCCGGGC -> ACATGCGTCACGTCCGGGCG
AGAACTCAGTCTACACGCTA -> GAACTCAGTCTACACGCTAA
TACGAGAACACTTGTTAGTT -> ACGAGAACACTTGTTAGTTA
TCTGAAGACCCGCACAGCCT -> CTGAAGACCCGCACAGCCTA
CGAGAACACTTGTTAGTTAC -> GAGAACACTTGTTAGTTACT
GGTACTCGTGCGCTCTTACA -> GTACTCGTGCGCTCTTACAG
GAGGACCATTAAAGGGCCTT -> AGGACCATTAAAGGGCCTTG
CTAACATTACAACACTACGA -> TAACATTACAACACTACGAT
GGAAACTGTAGCTCGAGTGA -> GAAACTGTAGCTCGAGTGAC
TTACAACACTACGATTTTAT -> TACAACACTACGATTTTATA
CATTAGACTAAGGTTGTGTT -> ATTAGACTAAGGTTGTGTTG
CGCGCCGCCATAGGTGAAGG -> GCGCCGCCATAGGTGAAGGT
ATAAGACGCGTGCACCAGTT -> TAAGACGCGTGCACCAGTTA
ATTTTATAAGACGCGTGCAC -> TTTTATAAGACGCGTGCACC
TGTGATCAATGAATGCTGTC -> GTGATCAATGAATGCTGTCG
GTGCACCAGTTATTATGTTA -> TGCACCAGTTATTATGTTAT
AAGCCCGCGCACCGAGGGAG -> AGCCCGCGCACCGAGGGAGA
AGTTACTACCTTGTCACCGT -> GTTACTACCTTGTCACCGTA
TGTTAGTTACTACCTTGTCA -> GTTAGTTACTACCTTGTCAC
AGGGGGCCTAATAACCTTGT -> GGGGGCCTAATAACCTTGTT
ACGTCGCGGGCGTCTCTAAT -> CGTCGCGGGCGTCTCTAATG
CGTAGTAATCTCGCAAGTAT -> GTAGTAATCTCGCAAGTATC
TACTTGGACTAACATTACAA -> ACTTGGACTAACATTACAAC
TTATTTTCACCGCACCATGA -> TATTTTCACCGCACCATGAC
GCTCTTGTCTCCATGTGTCA -> CTCTTGTCTCCATGTGTCAT
CAGTCTACACGCTAACTTCG -> AGTCTACACGCTAACTTCGT
TGTTATTTTCACCGCACCAT -> GTTATTTTCACCGCACCATG
AACCTTGTTGCTCACCACCA -> ACCTTGTTGCTCACCACCAG
AATCCAGCACTGGTACATGC -> ATCCAGCACTGGTACATGCG
CCAGGTACTCGTGCGCTCTT -> CAGGTACTCGTGCGCTCTTA
GTGGAGACAAGCTCTTGTCT -> TGGAGACAAGCTCTTGTCTC
TTTCACCGCACCATGACACG -> TTCACCGCACCATGACACGA
CGAGCCGTAAGTTTGGAGAC -> GAGCCGTAAGTTTGGAGACG
GCAATCATTAGACTAAGGTT -> CAATCATTAGACTAAGGTTG
ACCTCTGTGCAACGATTCGC -> CCTCTGTGCAACGATTCGCT
ATAACCTTGTTGCTCACCAC -> TAACCTTGTTGCTCACCACC
CACGGAGGACCATTAAAGGG -> ACGGAGGACCATTAAAGGGC
CGCGAAGATAAGTGGAGACA -> GCGAAGATAAGTGGAGACAA
TGCTTCTGAAGACCCGCACA -> GCTTCTGAAGACCCGCACAG
ACACTACGATTTTATAAGAC -> CACTACGATTTTATAAGACG
GAAGCCCGCGCACCGAGGGA -> AAGCCCGCGCACCGAGGGAG
CACTGAGGTGACACGGAGGA -> ACTGAGGTGACACGGAGGAC
CTTAACCGCGCCGCCATAGG -> TTAACCGCGCCGCCATAGGT
CCTGAACAGCCCCACACTGC -> CTGAACAGCCCCACACTGCG
TCTTCACGGTAAGAACGCCT -> CTTCACGGTAAGAACGCCTT
TCCAGGGTTCGCCTAGGCTC -> CCAGGGTTCGCCTAGGCTCA
CAACACTACGATTTTATAAG -> AACACTACGATTTTATAAGA
CCTATCGCGAAGATAAGTGG -> CTATCGCGAAGATAAGTGGA
ACTCGTGCGCTCTTACAGAT -> CTCGTGCGCTCTTACAGATG
GAATAATCCAGCACTGGTAC -> AATAATCCAGCACTGGTACA
TATTATGTTATTTTCACCGC -> ATTATGTTATTTTCACCGCA
CTCCAGGGTTCGCCTAGGCT -> TCCAGGGTTCGCCTAGGCTC
AAGGTTGTGTTGAGGCTCTC -> AGGTTGTGTTGAGGCTCTCC
GGGTTTCTCCGCTCACCTGA -> GGTTTCTCCGCTCACCTGAT
CTTCGTTTGTGATCAATGAA -> TTCGTTTGTGATCAATGAAT
CTAATGCACATCGACGCAAT -> TAATGCACATCGACGCAATC
CATTTACTTTCTGGCCACGT -> ATTTACTTTCTGGCCACGTG
CTCGAGCCGTAAGTTTGGAG -> TCGAGCCGTAAGTTTGGAGA
TGTTCTACGAGAACACTTGT -> GTTCTACGAGAACACTTGTT
CTTTCTGGCCACGTGTCTTC -> TTTCTGGCCACGTGTCTTCA
AATGCTGTCGTGTACACACG -> ATGCTGTCGTGTACACACGT
ACAGCCCCACACTGCGACTG -> CAGCCCCACACTGCGACTGA
GCCCCACACTGCGACTGAAT -> CCCCACACTGCGACTGAATA
CAGCACTGGTACATGCGTCA -> AGCACTGGTACATGCGTCAC
AGGACCATTAAAGGGCCTTG -> GGACCATTAAAGGGCCTTGA
GCTGTGGCACTGAGGTGACA -> CTGTGGCACTGAGGTGACAC
CGCTCTTACAGATGAACCGG -> GCTCTTACAGATGAACCGGG
CGAAGTACCCCTGTCTCAAC -> GAAGTACCCCTGTCTCAACG
GAAGACCCGCACAGCCTATC -> AAGACCCGCACAGCCTATCG
ATGAACCGGGAGAGCCCCTC -> TGAACCGGGAGAGCCCCTCA
AGCTCTTGTCTCCATGTGTC -> GCTCTTGTCTCCATGTGTCA
AACACTTGTTAGTTACTACC -> ACACTTGTTAGTTACTACCT
CCGCGCGCACACCTCGTACA -> CGCGCGCACACCTCGTACAT
TTTTATAAGACGCGTGCACC -> TTTATAAGACGCGTGCACCA
GGTTCGCCTAGGCTCAGACT -> GTTCGCCTAGGCTCAGACTC
CTGTGGCACTGAGGTGACAC -> TGTGGCACTGAGGTGACACG
CTGAGGTGACACGGAGGACC -> TGAGGTGACACGGAGGACCA
GGGGGCCTAATAACCTTGTT -> GGGGCCTAATAACCTTGTTG
ACGTGTCTTCACGGTAAGAA -> CGTGTCTTCACGGTAAGAAC
GTGTACACACGTCGCGGGCG -> TGTACACACGTCGCGGGCGT
CCATTAAAGGGCCTTGATCA -> CATTAAAGGGCCTTGATCAG
ATCGCTCAATTTCTTGCCTG -> TCGCTCAATTTCTTGCCTGC
GTGCGCTCTTACAGATGAAC -> TGCGCTCTTACAGATGAACC
TTGTCACCGTAGTAATCTCG -> TGTCACCGTAGTAATCTCGC
CAGGGTTCGCCTAGGCTCAG -> AGGGTTCGCCTAGGCTCAGA
GTGCCGCGCGCACACCTCGT -> TGCCGCGCGCACACCTCGTA
TACCTCTGTGCAACGATTCG -> ACCTCTGTGCAACGATTCGC
CTCTCCGCGTCATGCAACTC -> TCTCCGCGTCATGCAACTCT
CCGGGCGTACGAAGCCCGCG -> CGGGCGTACGAAGCCCGCGC
TCTCCGCTCACCTGATTCTG -> CTCCGCTCACCTGATTCTGG
CACGCTAACTTCGTTTGTGA -> ACGCTAACTTCGTTTGTGAT
CTCGCAAGTATCACCGGGAA -> TCGCAAGTATCACCGGGAAC
TCCATGTGTCATGAATCTGA -> CCATGTGTCATGAATCTGAC
TTGTCTCCATGTGTCATGAA -> TGTCTCCATGTGTCATGAAT
ACGCCGCTGCTGTTCTACGA -> CGCCGCTGCTGTTCTACGAG
AATCATTAGACTAAGGTTGT -> ATCATTAGACTAAGGTTGTG
AAGATAAGTGGAGACAAGCT -> AGATAAGTGGAGACAAGCTC
CAGGATAGTGAGTTTCTTCC -> AGGATAGTGAGTTTCTTCCA
ACACGGAGGACCATTAAAGG -> CACGGAGGACCATTAAAGGG
CCGTAAGTTTGGAGACGCCG -> CGTAAGTTTGGAGACGCCGC
GCGTCTCTAATGCCCAGGAT -> CGTCTCTAATGCCCAGGATA
TTTACTTTCTGGCCACGTGT -> TTACTTTCTGGCCACGTGTC
TGCAAATCACTGCTTCTGAA -> GCAAATCACTGCTTCTGAAG
CACGTGTCTTCACGGTAAGA -> ACGTGTCTTCACGGTAAGAA
TGAATCTGACTAATGCACAT -> GAATCTGACTAATGCACATC
CACAGCCTATCGCGAAGATA -> ACAGCCTATCGCGAAGATAA
TTGGAGACGCCGCTGCTGTT -> TGGAGACGCCGCTGCTGTTC
CACACTGCGACTGAATAATC -> ACACTGCGACTGAATAATCC
GGGCATTAGAAGGATGGTAC -> GGCATTAGAAGGATGGTACT
ATAGGTGAAGGTGGAAACTG -> TAGGTGAAGGTGGAAACTGT
TGAGGTGACACGGAGGACCA -> GAGGTGACACGGAGGACCAT
ATAAGTGGAGACAAGCTCTT -> TAAGTGGAGACAAGCTCTTG
AGGATAGTGAGTTTCTTCCA -> GGATAGTGAGTTTCTTCCAC
CCTCTGTGCAACGATTCGCT -> CTCTGTGCAACGATTCGCTT
CTATCGCGAAGATAAGTGGA -> TATCGCGAAGATAAGTGGAG
GTCATGAATCTGACTAATGC -> TCATGAATCTGACTAATGCA
TTGAGGCTCTCCAGGGTTCG -> TGAGGCTCTCCAGGGTTCGC
TAAGTTTGGAGACGCCGCTG -> AAGTTTGGAGACGCCGCTGC
CTCGAGTGACAATGGGAACT -> TCGAGTGACAATGGGAACTC
CACGTCCGGGCGTACGAAGC -> ACGTCCGGGCGTACGAAGCC
GAATTCTGATTCGCTAGGGG -> AATTCTGATTCGCTAGGGGG
GGATGGTACTAGTGCCGCGC -> GATGGTACTAGTGCCGCGCG
CTTGTTAGTTACTACCTTGT -> TTGTTAGTTACTACCTTGTC
GGTGGAAACTGTAGCTCGAG -> GTGGAAACTGTAGCTCGAGT
CTACCTTGTCACCGTAGTAA -> TACCTTGTCACCGTAGTAAT
GAACACTTGTTAGTTACTAC -> AACACTTGTTAGTTACTACC
AGAACGGCAGCTCAGGGTAC -> GAACGGCAGCTCAGGGTACA
TGCGCTCTTACAGATGAACC -> GCGCTCTTACAGATGAACCG
TTACTACCTTGTCACCGTAG -> TACTACCTTGTCACCGTAGT
ATGCGTCACGTCCGGGCGTA -> TGCGTCACGTCCGGGCGTAC
TGGAGACAAGCTCTTGTCTC -> GGAGACAAGCTCTTGTCTCC
ATTTTCACCGCACCATGACA -> TTTTCACCGCACCATGACAC
CACTGCTTCTGAAGACCCGC -> ACTGCTTCTGAAGACCCGCA
TAGTAATCTCGCAAGTATCA -> AGTAATCTCGCAAGTATCAC
GACTAATGCACATCGACGCA -> ACTAATGCACATCGACGCAA
ATTCTGGTTTTACCTCTGTG -> TTCTGGTTTTACCTCTGTGC
TTACTTGGACTAACATTACA -> TACTTGGACTAACATTACAA
CATTGTGCAAATCACTGCTT -> ATTGTGCAAATCACTGCTTC
TCACCGTAGTAATCTCGCAA -> CACCGTAGTAATCTCGCAAG
TCTCCAGGGTTCGCCTAGGC -> CTCCAGGGTTCGCCTAGGCT
TCTTGAGTGATCGCTCAATT -> CTTGAGTGATCGCTCAATTT
GGAGACAAGCTCTTGTCTCC -> GAGACAAGCTCTTGTCTCCA
TCTTGCCTGCTGTGGCACTG -> CTTGCCTGCTGTGGCACTGA
TCTACGAGAACACTTGTTAG -> CTACGAGAACACTTGTTAGT
GCAATTCCTGAACAGCCCCA -> CAATTCCTGAACAGCCCCAC
CTAGGGGGCCTAATAACCTT -> TAGGGGGCCTAATAACCTTG
ATGGTACTAGTGCCGCGCGC -> TGGTACTAGTGCCGCGCGCA
TAACATTACAACACTACGAT -> AACATTACAACACTACGATT
CACTGGTACATGCGTCACGT -> ACTGGTACATGCGTCACGTC
TTGAGTGATCGCTCAATTTC -> TGAGTGATCGCTCAATTTCT
CTGCTGTGGCACTGAGGTGA -> TGCTGTGGCACTGAGGTGAC
ATTAGAAGGATGGTACTAGT -> TTAGAAGGATGGTACTAGTG
CAATCATTAGACTAAGGTTG -> AATCATTAGACTAAGGTTGT
TGATTCGCTAGGGGGCCTAA -> GATTCGCTAGGGGGCCTAAT
ACACCTCGTACATTTACTTT -> CACCTCGTACATTTACTTTC
GCACATCGACGCAATCATTA -> CACATCGACGCAATCATTAG
ACTGCGACTGAATAATCCAG -> CTGCGACTGAATAATCCAGC
TGAGTGATCGCTCAATTTCT -> GAGTGATCGCTCAATTTCTT
ATCGACGCAATCATTAGACT -> TCGACGCAATCATTAGACTA
GAGCCGTAAGTTTGGAGACG -> AGCCGTAAGTTTGGAGACGC
CGTGCGCTCTTACAGATGAA -> GTGCGCTCTTACAGATGAAC
CTTGTTGCTCACCACCAGGT -> TTGTTGCTCACCACCAGGTA
GTTGAGGCTCTCCAGGGTTC -> TTGAGGCTCTCCAGGGTTCG
CTCCGCGTCATGCAACTCTT -> TCCGCGTCATGCAACTCTTG
ACTAGTGCCGCGCGCACACC -> CTAGTGCCGCGCGCACACCT
AGTGAGTTTCTTCCACAACA -> GTGAGTTTCTTCCACAACAA
ATAGTGAGTTTCTTCCACAA -> TAGTGAGTTTCTTCCACAAC
TGGGAACTCCAGGGCATTAG -> GGGAACTCCAGGGCATTAGA
ACTCTTGAGTGATCGCTCAA -> CTCTTGAGTGATCGCTCAAT
TATTTTCACCGCACCATGAC -> ATTTTCACCGCACCATGACA
TGCTGTCGTGTACACACGTC -> GCTGTCGTGTACACACGTCG
GAAGGATGGTACTAGTGCCG -> AAGGATGGTACTAGTGCCGC
ACCCGCACAGCCTATCGCGA -> CCCGCACAGCCTATCGCGAA
TCACGTCCGGGCGTACGAAG -> CACGTCCGGGCGTACGAAGC
ACCACCAGGTACTCGTGCGC -> CCACCAGGTACTCGTGCGCT
GCGCACACCTCGTACATTTA -> CGCACACCTCGTACATTTAC
ATTATGTTATTTTCACCGCA -> TTATGTTATTTTCACCGCAC
GAGACGCCGCTGCTGTTCTA -> AGACGCCGCTGCTGTTCTAC
GGTACTAGTGCCGCGCGCAC -> GTACTAGTGCCGCGCGCACA
AATAATCCAGCACTGGTACA -> ATAATCCAGCACTGGTACAT
GTAGCTCGAGTGACAATGGG -> TAGCTCGAGTGACAATGGGA
CAATGAATGCTGTCGTGTAC -> AATGAATGCTGTCGTGTACA
GCAACGATTCGCTTCCTCAC -> CAACGATTCGCTTCCTCACT
TCACCACCAGGTACTCGTGC -> CACCACCAGGTACTCGTGCG
TACGATTTTATAAGACGCGT -> ACGATTTTATAAGACGCGTG
TTATTATGTTATTTTCACCG -> TATTATGTTATTTTCACCGC
GCTCAGACTCGAGCCGTAAG -> CTCAGACTCGAGCCGTAAGT
GTACATGCGTCACGTCCGGG -> TACATGCGTCACGTCCGGGC
CACTCTCCGCGTCATGCAAC -> ACTCTCCGCGTCATGCAACT
GCAGCTCAGGGTACATTGTG -> CAGCTCAGGGTACATTGTGC
GCTAGGGGGCCTAATAACCT -> CTAGGGGGCCTAATAACCTT
ATGCAACTCTTGAGTGATCG -> TGCAACTCTTGAGTGATCGC
GCCGTAAGTTTGGAGACGCC -> CCGTAAGTTTGGAGACGCCG
GAACCTGAAGGCAAGGCACT -> AACCTGAAGGCAAGGCACTT
CTCCAGGGCATTAGAAGGAT -> TCCAGGGCATTAGAAGGATG
TCCACAACAACGAATGTCCA -> CCACAACAACGAATGTCCAA
CTGAACAGCCCCACACTGCG -> TGAACAGCCCCACACTGCGA
AGTAATCTCGCAAGTATCAC -> GTAATCTCGCAAGTATCACC
CTAATGCCCAGGATAGTGAG -> TAATGCCCAGGATAGTGAGT
TAATGCACATCGACGCAATC -> AATGCACATCGACGCAATCA
AGGCACTTAACCGCGCCGCC -> GGCACTTAACCGCGCCGCCA
ATGCCCAGGATAGTGAGTTT -> TGCCCAGGATAGTGAGTTTC
TCGACGCAATCATTAGACTA -> CGACGCAATCATTAGACTAA
CCGAGGGAGAACGGCAGCTC -> CGAGGGAGAACGGCAGCTCA
AGGGCCTTGATCAGAACTCA -> GGGCCTTGATCAGAACTCAG
GACCATTAAAGGGCCTTGAT -> ACCATTAAAGGGCCTTGATC
GAACAGCCCCACACTGCGAC -> AACAGCCCCACACTGCGACT
AGGGTACATTGTGCAAATCA -> GGGTACATTGTGCAAATCAC
CGTGTACACACGTCGCGGGC -> GTGTACACACGTCGCGGGCG
AGATAAGTGGAGACAAGCTC -> GATAAGTGGAGACAAGCTCT
CATTAAAGGGCCTTGATCAG -> ATTAAAGGGCCTTGATCAGA
TACATTGTGCAAATCACTGC -> ACATTGTGCAAATCACTGCT
AAGGGCCTTGATCAGAACTC -> AGGGCCTTGATCAGAACTCA
CAGACTCGAGCCGTAAGTTT -> AGACTCGAGCCGTAAGTTTG
AGAGCCCCTCAGAACCTGAA -> GAGCCCCTCAGAACCTGAAG
AAGGATGGTACTAGTGCCGC -> AGGATGGTACTAGTGCCGCG
CGCTCAATTTCTTGCCTGCT -> GCTCAATTTCTTGCCTGCTG
CGCGTGCACCAGTTATTATG -> GCGTGCACCAGTTATTATGT
AGTGCCGCGCGCACACCTCG -> GTGCCGCGCGCACACCTCGT
CGAAGATAAGTGGAGACAAG -> GAAGATAAGTGGAGACAAGC
GTACTCGTGCGCTCTTACAG -> TACTCGTGCGCTCTTACAGA
GTGATCGCTCAATTTCTTGC -> TGATCGCTCAATTTCTTGCC
TGGTACATGCGTCACGTCCG -> GGTACATGCGTCACGTCCGG
GCGTCACGTCCGGGCGTACG -> CGTCACGTCCGGGCGTACGA
AGTTTCTTCCACAACAACGA -> GTTTCTTCCACAACAACGAA
TAACCGCGCCGCCATAGGTG -> AACCGCGCCGCCATAGGTGA
GACCCGCACAGCCTATCGCG -> ACCCGCACAGCCTATCGCGA
CACCAGGTACTCGTGCGCTC -> ACCAGGTACTCGTGCGCTCT
ACTCAGTCTACACGCTAACT -> CTCAGTCTACACGCTAACTT
CCGCGTCATGCAACTCTTGA -> CGCGTCATGCAACTCTTGAG
TGGCACTGAGGTGACACGGA -> GGCACTGAGGTGACACGGAG
CCACACTGCGACTGAATAAT -> CACACTGCGACTGAATAATC
TAGGGGGCCTAATAACCTTG -> AGGGGGCCTAATAACCTTGT
TTCTGGCCACGTGTCTTCAC -> TCTGGCCACGTGTCTTCACG
GTTACTACCTTGTCACCGTA -> TTACTACCTTGTCACCGTAG
TAACTTCGTTTGTGATCAAT -> AACTTCGTTTGTGATCAATG
GGGAGAACGGCAGCTCAGGG -> GGAGAACGGCAGCTCAGGGT
TGATCGCTCAATTTCTTGCC -> GATCGCTCAATTTCTTGCCT
CGCGCACACCTCGTACATTT -> GCGCACACCTCGTACATTTA
GCTCTTACAGATGAACCGGG -> CTCTTACAGATGAACCGGGA
TCTTGTCTCCATGTGTCATG -> CTTGTCTCCATGTGTCATGA
CCGTAGTAATCTCGCAAGTA -> CGTAGTAATCTCGCAAGTAT
TCACTCTCCGCGTCATGCAA -> CACTCTCCGCGTCATGCAAC
GTGATCAATGAATGCTGTCG -> TGATCAATGAATGCTGTCGT
CCACAACAACGAATGTCCAA -> CACAACAACGAATGTCCAAA
CCCGCGCACCGAGGGAGAAC -> CCGCGCACCGAGGGAGAACG
ACAGATGAACCGGGAGAGCC -> CAGATGAACCGGGAGAGCCC
TGTCTCAACGGATGCCTGCA -> GTCTCAACGGATGCCTGCAA
GTGTCATGAATCTGACTAAT -> TGTCATGAATCTGACTAATG
TCGCCTAGGCTCAGACTCGA -> CGCCTAGGCTCAGACTCGAG
TTCTCCGCTCACCTGATTCT -> TCTCCGCTCACCTGATTCTG
AACTCAGTCTACACGCTAAC -> ACTCAGTCTACACGCTAACT
ACCTTGTTGCTCACCACCAG -> CCTTGTTGCTCACCACCAGG
TAGGTGAAGGTGGAAACTGT -> AGGTGAAGGTGGAAACTGTA
TCGAGCCGTAAGTTTGGAGA -> CGAGCCGTAAGTTTGGAGAC
GGCAAGGCACTTAACCGCGC -> GCAAGGCACTTAACCGCGCC
GCACTTAACCGCGCCGCCAT -> CACTTAACCGCGCCGCCATA
TGCCGCGCGCACACCTCGTA -> GCCGCGCGCACACCTCGTAC
AACGCCTTTACTTGGACTAA -> ACGCCTTTACTTGGACTAAC
CGGCAGCTCAGGGTACATTG -> GGCAGCTCAGGGTACATTGT
TTCCTGAACAGCCCCACACT -> TCCTGAACAGCCCCACACTG
ACACTTGTTAGTTACTACCT -> CACTTGTTAGTTACTACCTT
GTACATTGTGCAAATCACTG -> TACATTGTGCAAATCACTGC
GTCTTCACGGTAAGAACGCC -> TCTTCACGGTAAGAACGCCT
AACGATTCGCTTCCTCACTC -> ACGATTCGCTTCCTCACTCT
AATCTGACTAATGCACATCG -> ATCTGACTAATGCACATCGA
AATGTCCAAAAGGAATTCTG -> ATGTCCAAAAGGAATTCTGA
AACGGATGCCTGCAATTCCT -> ACGGATGCCTGCAATTCCTG
CACCGTAGTAATCTCGCAAG -> ACCGTAGTAATCTCGCAAGT
CCGCTCACCTGATTCTGGTT -> CGCTCACCTGATTCTGGTTT
ACACGAAGTACCCCTGTCTC -> CACGAAGTACCCCTGTCTCA
AATGCACATCGACGCAATCA -> ATGCACATCGACGCAATCAT
CAGGGTACATTGTGCAAATC -> AGGGTACATTGTGCAAATCA
TTGTTAGTTACTACCTTGTC -> TGTTAGTTACTACCTTGTCA
GCGACTGAATAATCCAGCAC -> CGACTGAATAATCCAGCACT
CGCTAACTTCGTTTGTGATC -> GCTAACTTCGTTTGTGATCA
ATCATTAGACTAAGGTTGTG -> TCATTAGACTAAGGTTGTGT
CCAAAAGGAATTCTGATTCG -> CAAAAGGAATTCTGATTCGC
TTGCTCACCACCAGGTACTC -> TGCTCACCACCAGGTACTCG
TACATTTACTTTCTGGCCAC -> ACATTTACTTTCTGGCCACG
ATTTACTTTCTGGCCACGTG -> TTTACTTTCTGGCCACGTGT
ACAGCCTATCGCGAAGATAA -> CAGCCTATCGCGAAGATAAG
GCCTAATAACCTTGTTGCTC -> CCTAATAACCTTGTTGCTCA
TCCTGAACAGCCCCACACTG -> CCTGAACAGCCCCACACTGC
CGTCCGGGCGTACGAAGCCC -> GTCCGGGCGTACGAAGCCCG
AAAGGAATTCTGATTCGCTA -> AAGGAATTCTGATTCGCTAG
GGATAGTGAGTTTCTTCCAC -> GATAGTGAGTTTCTTCCACA
GCTCACCACCAGGTACTCGT -> CTCACCACCAGGTACTCGTG
ACTACCTTGTCACCGTAGTA -> CTACCTTGTCACCGTAGTAA
GTACTAGTGCCGCGCGCACA -> TACTAGTGCCGCGCGCACAC
ATTTCTTGCCTGCTGTGGCA -> TTTCTTGCCTGCTGTGGCAC
CTACACGCTAACTTCGTTTG -> TACACGCTAACTTCGTTTGT
GATAAGTGGAGACAAGCTCT -> ATAAGTGGAGACAAGCTCTT
CGGAGGACCATTAAAGGGCC -> GGAGGACCATTAAAGGGCCT
AGGTGAAGGTGGAAACTGTA -> GGTGAAGGTGGAAACTGTAG
TCATGCAACTCTTGAGTGAT -> CATGCAACTCTTGAGTGATC
TCCAAAAGGAATTCTGATTC -> CCAAAAGGAATTCTGATTCG
GCTGTTCTACGAGAACACTT -> CTGTTCTACGAGAACACTTG
GTACGAAGCCCGCGCACCGA -> TACGAAGCCCGCGCACCGAG
GAGTTTCTTCCACAACAACG -> AGTTTCTTCCACAACAACGA
TCTCCGCGTCATGCAACTCT -> CTCCGCGTCATGCAACTCTT
CTTCCACAACAACGAATGTC -> TTCCACAACAACGAATGTCC
CAACAACGAATGTCCAAAAG -> AACAACGAATGTCCAAAAGG
AGCCGTAAGTTTGGAGACGC -> GCCGTAAGTTTGGAGACGCC
ATGTGTCATGAATCTGACTA -> TGTGTCATGAATCTGACTAA
TGGTACTAGTGCCGCGCGCA -> GGTACTAGTGCCGCGCGCAC
CTAAGGTTGTGTTGAGGCTC -> TAAGGTTGTGTTGAGGCTCT
TCGCTTCCTCACTCTCCGCG -> CGCTTCCTCACTCTCCGCGT
CGCCTAGGCTCAGACTCGAG -> GCCTAGGCTCAGACTCGAGC
TGCAATTCCTGAACAGCCCC -> GCAATTCCTGAACAGCCCCA
CTTCCTCACTCTCCGCGTCA -> TTCCTCACTCTCCGCGTCAT
AAGGTGGAAACTGTAGCTCG -> AGGTGGAAACTGTAGCTCGA
GCACTGGTACATGCGTCACG -> CACTGGTACATGCGTCACGT
TTCTTGCCTGCTGTGGCACT -> TCTTGCCTGCTGTGGCACTG
CTAGGCTCAGACTCGAGCCG -> TAGGCTCAGACTCGAGCCGT
CCCAGGATAGTGAGTTTCTT -> CCAGGATAGTGAGTTTCTTC
CGCGCGCACACCTCGTACAT -> GCGCGCACACCTCGTACATT
ACGATTCGCTTCCTCACTCT -> CGATTCGCTTCCTCACTCTC
TGAATGCTGTCGTGTACACA -> GAATGCTGTCGTGTACACAC
GTCCGGGCGTACGAAGCCCG -> TCCGGGCGTACGAAGCCCGC
TAGTGCCGCGCGCACACCTC -> AGTGCCGCGCGCACACCTCG
GTCTCCATGTGTCATGAATC -> TCTCCATGTGTCATGAATCT
GCTCAATTTCTTGCCTGCTG -> CTCAATTTCTTGCCTGCTGT
GCCGCTGCTGTTCTACGAGA -> CCGCTGCTGTTCTACGAGAA
CGGGTTTCTCCGCTCACCTG -> GGGTTTCTCCGCTCACCTGA
CAGCCTATCGCGAAGATAAG -> AGCCTATCGCGAAGATAAGT
AAGACGCGTGCACCAGTTAT -> AGACGCGTGCACCAGTTATT
AGTTATTATGTTATTTTCAC -> GTTATTATGTTATTTTCACC
TGCCTGCTGTGGCACTGAGG -> GCCTGCTGTGGCACTGAGGT
GTTCGCCTAGGCTCAGACTC -> TTCGCCTAGGCTCAGACTCG
TGTGTCATGAATCTGACTAA -> GTGTCATGAATCTGACTAAT
TAATCTCGCAAGTATCACCG -> AATCTCGCAAGTATCACCGG
GTTTGGAGACGCCGCTGCTG -> TTTGGAGACGCCGCTGCTGT
ACACGCTAACTTCGTTTGTG -> CACGCTAACTTCGTTTGTGA
TGGCCACGTGTCTTCACGGT -> GGCCACGTGTCTTCACGGTA
AACGGCAGCTCAGGGTACAT -> ACGGCAGCTCAGGGTACATT
CTCTGTGCAACGATTCGCTT -> TCTGTGCAACGATTCGCTTC
CAGTTATTATGTTATTTTCA -> AGTTATTATGTTATTTTCAC
GTTATTTTCACCGCACCATG -> TTATTTTCACCGCACCATGA
CTGTCGTGTACACACGTCGC -> TGTCGTGTACACACGTCGCG
GGTTTTACCTCTGTGCAACG -> GTTTTACCTCTGTGCAACGA
TTAGAAGGATGGTACTAGTG -> TAGAAGGATGGTACTAGTGC
CCCTGTCTCAACGGATGCCT -> CCTGTCTCAACGGATGCCTG
CGCCTTTACTTGGACTAACA -> GCCTTTACTTGGACTAACAT
GTCACCGTAGTAATCTCGCA -> TCACCGTAGTAATCTCGCAA
GGTTTCTCCGCTCACCTGAT -> GTTTCTCCGCTCACCTGATT
AACCGCGCCGCCATAGGTGA -> ACCGCGCCGCCATAGGTGAA
CTTCACGGTAAGAACGCCTT -> TTCACGGTAAGAACGCCTTT
GAGGTGACACGGAGGACCAT -> AGGTGACACGGAGGACCATT
ACCTTGTCACCGTAGTAATC -> CCTTGTCACCGTAGTAATCT
CGATTCGCTTCCTCACTCTC -> GATTCGCTTCCTCACTCTCC
TAGACTAAGGTTGTGTTGAG -> AGACTAAGGTTGTGTTGAGG
CGAAGCCCGCGCACCGAGGG -> GAAGCCCGCGCACCGAGGGA
GGCTCTCCAGGGTTCGCCTA -> GCTCTCCAGGGTTCGCCTAG
GGAGAACGGCAGCTCAGGGT -> GAGAACGGCAGCTCAGGGTA
CTCAGGGTACATTGTGCAAA -> TCAGGGTACATTGTGCAAAT
ACTGGTACATGCGTCACGTC -> CTGGTACATGCGTCACGTCC
GAGACAAGCTCTTGTCTCCA -> AGACAAGCTCTTGTCTCCAT
ACTAAGGTTGTGTTGAGGCT -> CTAAGGTTGTGTTGAGGCTC
TCCTCACTCTCCGCGTCATG -> CCTCACTCTCCGCGTCATGC
TCTGGTTTTACCTCTGTGCA -> CTGGTTTTACCTCTGTGCAA
ACCTGATTCTGGTTTTACCT -> CCTGATTCTGGTTTTACCTC
AATTCCTGAACAGCCCCACA -> ATTCCTGAACAGCCCCACAC
ACTGTAGCTCGAGTGACAAT -> CTGTAGCTCGAGTGACAATG
TGCACCAGTTATTATGTTAT -> GCACCAGTTATTATGTTATT
TTCTTCCACAACAACGAATG -> TCTTCCACAACAACGAATGT
GGCCACGTGTCTTCACGGTA -> GCCACGTGTCTTCACGGTAA
ATGACACGAAGTACCCCTGT -> TGACACGAAGTACCCCTGTC
AATGGGAACTCCAGGGCATT -> ATGGGAACTCCAGGGCATTA
CACGGTAAGAACGCCTTTAC -> ACGGTAAGAACGCCTTTACT
CCGCTGCTGTTCTACGAGAA -> CGCTGCTGTTCTACGAGAAC
AGACGCGTGCACCAGTTATT -> GACGCGTGCACCAGTTATTA
GACAATGGGAACTCCAGGGC -> ACAATGGGAACTCCAGGGCA
TGACACGAAGTACCCCTGTC -> GACACGAAGTACCCCTGTCT
GATTCGCTTCCTCACTCTCC -> ATTCGCTTCCTCACTCTCCG
CCTAGGCTCAGACTCGAGCC -> CTAGGCTCAGACTCGAGCCG
CGAGGGAGAACGGCAGCTCA -> GAGGGAGAACGGCAGCTCAG
CTCAGTCTACACGCTAACTT -> TCAGTCTACACGCTAACTTC
AACAGCCCCACACTGCGACT -> ACAGCCCCACACTGCGACTG
GTTTCTCCGCTCACCTGATT -> TTTCTCCGCTCACCTGATTC
GCTAACTTCGTTTGTGATCA -> CTAACTTCGTTTGTGATCAA
ACTAACATTACAACACTACG -> CTAACATTACAACACTACGA
ATAATCCAGCACTGGTACAT -> TAATCCAGCACTGGTACATG
CATTACAACACTACGATTTT -> ATTACAACACTACGATTTTA
AACAACGAATGTCCAAAAGG -> ACAACGAATGTCCAAAAGGA
TTGTGCAAATCACTGCTTCT -> TGTGCAAATCACTGCTTCTG
TCGTGTACACACGTCGCGGG -> CGTGTACACACGTCGCGGGC
ACCGCACCATGACACGAAGT -> CCGCACCATGACACGAAGTA
GTCACGTCCGGGCGTACGAA -> TCACGTCCGGGCGTACGAAG
CACCGAGGGAGAACGGCAGC -> ACCGAGGGAGAACGGCAGCT
AGCACTGGTACATGCGTCAC -> GCACTGGTACATGCGTCACG
CTTTACTTGGACTAACATTA -> TTTACTTGGACTAACATTAC
CCTCGTACATTTACTTTCTG -> CTCGTACATTTACTTTCTGG
ATGCCTGCAATTCCTGAACA -> TGCCTGCAATTCCTGAACAG
ATGAATGCTGTCGTGTACAC -> TGAATGCTGTCGTGTACACA
GGCTCAGACTCGAGCCGTAA -> GCTCAGACTCGAGCCGTAAG
GGCACTTAACCGCGCCGCCA -> GCACTTAACCGCGCCGCCAT
AGGGCATTAGAAGGATGGTA -> GGGCATTAGAAGGATGGTAC
AGGCTCTCCAGGGTTCGCCT -> GGCTCTCCAGGGTTCGCCTA
CAACGATTCGCTTCCTCACT -> AACGATTCGCTTCCTCACTC
CTGATTCTGGTTTTACCTCT -> TGATTCTGGTTTTACCTCTG
GCCTGCTGTGGCACTGAGGT -> CCTGCTGTGGCACTGAGGTG
TTTCTTCCACAACAACGAAT -> TTCTTCCACAACAACGAATG
ATCTGACTAATGCACATCGA -> TCTGACTAATGCACATCGAC
CAAAAGGAATTCTGATTCGC -> AAAAGGAATTCTGATTCGCT
ACAATGGGAACTCCAGGGCA -> CAATGGGAACTCCAGGGCAT
CATTAGAAGGATGGTACTAG -> ATTAGAAGGATGGTACTAGT
TCGCGGGCGTCTCTAATGCC -> CGCGGGCGTCTCTAATGCCC
GGACTAACATTACAACACTA -> GACTAACATTACAACACTAC
TGTGTTGAGGCTCTCCAGGG -> GTGTTGAGGCTCTCCAGGGT
TACTCGTGCGCTCTTACAGA -> ACTCGTGCGCTCTTACAGAT
TAGTGAGTTTCTTCCACAAC -> AGTGAGTTTCTTCCACAACA